30 100
GAGGGGACACGGTGCGTTTTATTTGATCCA|CTGCGGTCAAAAGCGAGGGTGTGATGGTCT
CTAGGGATGAGTCGCTTAGCTTATACAATT|TCCGTCCGTCACAATAGCTTATACAATTAC
GTCGCCCTACGAATCTTCGAGCGCACGCCT|CATCACTTAGCTTATACAATAGCTTATACA
AATAATATTCTCGCCACCGACGTCGAACCA|GGTCCGGGTGGCAGTCGCCCTACGAATCTT
CAATAGCTTATACAATTACAATCCTTCCGA|AAGGCGTCTTTTGGGGGAGGGGACACGGTG
CTGCCCGATTTTCGCTATCCCATGGGTCCG|TCGCCACCGACGTCGAACCAGGTACAGACA
CGTAGCTTATACAATTACAATCCTTCCGAA|CAATCCTTCCGAATATCCTTCCGAATACGG
ACAGACAATGGGAGCTGGAAGCTCCGTCCG|GCGCACGCCTATGATACTAGTTGGTTTGCC
ATAGCTTATACAATTACAATAGCTTATACA|GCTTATTCTGCGACCAAAGGCGTCTTTTGG
GATTGTTTTCCGATATTTCAGAAGGCATGT|ATAGCTTATACAATTACAATCCTTCCGAAT
CTAGCTTATACAATTACAATCCTTCCGAAT|TCGGACTCCTAGAAGTGACTGATCTGGTCG
GTTTTACTCGGGAAGGCAAGAATCTCGTAG|ACAATAGCTTATACAATTATAGCTTATACA
TCCTTCCGAATAAAAAGCCAGTAACTAGCA|TGATCTGGTCGACAGCTACAACATCGGTGG
TCCTTCCGAATAACGCGTGACTGCAGGGAA|AAATTGGAGGGAAGAGTGCTAATCGGGGTA
AGCTTATACAATTACAATCCTTCCGAATAT|CTTATACAATTACAATAGCTTATACAATTA
CAGAAGGCATGTCTAAAGGTCGGGTTTGGG|ATCCTTCCGAATACAATCCTTCCGAATAGA
ATACAATTACAATCCTTCCGAATATTACAA|TAGCGGAACCCAGCCCCGGTGGTTAGCCGT
AGCTTATACAATTATAGCTTATACAATTAC|CCTTCCGAATATCAACGTGCCCACCTTAGA
TGCGACCAAAGGCGTCTTTTGGGGGAGGGG|AATAACGCGTGACTGCAGGGAACTCTGCGG
TAGCTTATACAATTACAATCCTTCCGAATA|GCTTATACAATTACAATAGCTTATACAATT
CTAAAGGTCGGGTTTGGGGTGCGGTCTAGC|ACAATCCTTCCGAATAGACTTAGCTTATAC
AAAGGTCGGGTTTGGGGTGCGGTCTAGCTT|AATCCTTCCGAATAGACTTAGCTTATACAA
CCCATGCAATCGGACTCCTAGAAGTGACTG|GGGACTTCATGCTGTTTTACTCGGGAAGGC
AGTCGCTTAGCTTATACAATTACAATCCTT|CACAATAGCTTATACAATTACAATAGCTTA
CGAATACAATCCTTCCGAATATTATAGCTT|TGCCCGATTTTCGCTATCCCATGGGTCCGT
ATTTTCGCTATCCCATGGGTCCGTATATGC|CGACGTCGAACCAGGTACAGACAATGGGAG
TAGCTTATACAATTACAATCCTTCCGAATA|GCGTCTTTTGGGGGAGGGGACACGGTGCGT
GAACCCGCGCATGCGCCGGGAACCACCCAT|TTTCAATCCAGTGGCTTACCCGCCAGGGAC
CCCTACGAATCTTCGAGCGCACGCCTATGA|ACTTAGCTTATACAATAGCTTATACAATTA
AATTGGAGGGAAGAGTGCTAATCGGGGTAT|TACCGACTTTAAACACATCCATGGTTCGGA
CCAAAGGCGTCTTTTGGGGGAGGGGACACG|CGCGTGACTGCAGGGAACTCTGCGGTCAAA
AATGGGAGCTGGAAGCTCCGTCCGTCACAA|GCCTATGATACTAGTTGGTTTGCCTCATGG
CTGACCCAGCTGGCACCCCTTCTTCTCCCC|CCGCGCATGCGCCGGGAACCACCCATGCAA
GCTACAACATCGGTGGGTTTGGTCTAGCAC|GCTTATACAATTACAATCCTTCCGAATAAA
GAACCCAGCCCCGGTGGTTAGCCGTAAATT|TACACCTGACCTTTTGTTTCGGTATATACC
TTATACAATAGCTTATACAATTATAGCTTA|AATTACAATCCTTCCGAATATCAACGTGCC
TTCCGAATAGACTTAGCTTATACAATTACA|TAGCTTATACAATTACAATCCTTCCGAATA
AATTACAATCCTTCCGAATAAAAAGCCAGT|GAAGTGACTGATCTGGTCGACAGCTACAAC
AGACATGACCTCCTGCAAAATGGCGTAGCT|CCCCCTAGCTTATACAATTACAATCCTTCC
CTAGCACAGTATATTGAGCATCTATTCCCC|GAATAAAATCCTGCGATTGTTTTCCGATAT
GAATATCAACGTGCCCACCTTAGATGAAAG|TATACAATTACAATCCTTCCGAATAATATT
ACGCGTGACTGCAGGGAACTCTGCGGTCAA|AGAGTGCTAATCGGGGTATATCACCCTGCG
GGTAAGCCGTGAGCTGACCCAGCTGGCACC|AGCCCAGTGGAACCCGCGCATGCGCCGGGA
GTGGTTAGCCGTAAATTGGAGGGAAGAGTG|TTGTTTCGGTATATACCGACTTTAAACACA
ATAGTAGCGGAACCCAGCCCCGGTGGTTAG|TATGGTTCTTACACCTGACCTTTTGTTTCG
AGCTTATACAATTACAATCCTTCCGAATAA|CAATTACAATCCTTCCGAATACAATCCTTC
CTTCTTCTCCCCCTAGCTTATACAATTACA|CCACCCATGCAATCGGACTCCTAGAAGTGA
GTAAATTGGAGGGAAGAGTGCTAATCGGGG|ATATACCGACTTTAAACACATCCATGGTTC
CAATCCTTCCGAATATCAACGTGCCCACCT|TATCGTAGCTTATACAATTACAATCCTTCC
GCTGTTTTACTCGGGAAGGCAAGAATCTCG|TATACAATAGCTTATACAATTATAGCTTAT
ACGAATCTTCGAGCGCACGCCTATGATACT|AGCTTATACAATAGCTTATACAATTACAAT
TCCTTCCGAATATCCTTCCGAATACGGTCC|GACACGGTGCGTTTTATTTGATCCAGAGAA
ACAGCTACAACATCGGTGGGTTTGGTCTAG|GTAGCTTATACAATTACAATCCTTCCGAAT
ATGGCTTATTCTGCGACCAAAGGCGTCTTT|CAATCCTTCCGAATAACGCGTGACTGCAGG
ATCCTTCCGAATATCCTTCCGAATACGGTC|GGACACGGTGCGTTTTATTTGATCCAGAGA
GTATGGGCTACCCCAATAGTAGCGGAACCC|TACTACACGACTGCATATGGTTCTTACACC
TGCGGTCAAAAGCGAGGGTGTGATGGTCTC|CACCCTGCGCGCTATCTTAGATTCGATTCG
CCGTATATGCTATTCACACTAGGGATGAGT|ACAATGGGAGCTGGAAGCTCCGTCCGTCAC
TTGGTCTAGCACAGTATATTGAGCATCTAT|CTTCCGAATAAAATCCTGCGATTGTTTTCC
AACTGGTGGTAAGCCGTGAGCTGACCCAGC|GGATCGAAGCCCAGTGGAACCCGCGCATGC
GAGAAGGCAACATCATCACTTAGCTTATAC|CCACTTGGGTGGCAGGTGGGTATGGGCTAC
ATAGCTTATACAATTATAGCTTATACAATT|ATCCTTCCGAATATCAACGTGCCCACCTTA
AGACAATTTCAATCCAGTGGCTTACCCGCC|GAAGGCATGTCTAAAGGTCGGGTTTGGGGT
TCCGGGTGGCAGTCGCCCTACGAATCTTCG|GAAGGCAACATCATCACTTAGCTTATACAA
GATCCAGAGAAGGCAACATCATCACTTAGC|TGGTCTCCACTTGGGTGGCAGGTGGGTATG
TGGAACCCGCGCATGCGCCGGGAACCACCC|AATTTCAATCCAGTGGCTTACCCGCCAGGG
CTGTTTTACTCGGGAAGGCAAGAATCTCGT|ATACAATAGCTTATACAATTATAGCTTATA
ACAATTACAATCCTTCCGAATACAATCCTT|ACCTTAGATGAAAGTCTGCCCGATTTTCGC
CTTCATGCTGTTTTACTCGGGAAGGCAAGA|CTAGCTTATACAATAGCTTATACAATTATA
CCCAATAGTAGCGGAACCCAGCCCCGGTGG|TGCATATGGTTCTTACACCTGACCTTTTGT
TCATGGCTTATTCTGCGACCAAAGGCGTCT|TACAATCCTTCCGAATAACGCGTGACTGCA
ATCCTGCGATTGTTTTCCGATATTTCAGAA|GAATATTATAGCTTATACAATTACAATCCT
GTCTTTTGGGGGAGGGGACACGGTGCGTTT|TGCAGGGAACTCTGCGGTCAAAAGCGAGGG
GATTTTCGCTATCCCATGGGTCCGTATATG|CCGACGTCGAACCAGGTACAGACAATGGGA
TGGTCTCCACTTGGGTGGCAGGTGGGTATG|CGATTCGTTCCACAAGATTCGAAATTACTA
TAGCTTATACAATTACAATAGCTTATACAA|CTTATTCTGCGACCAAAGGCGTCTTTTGGG
TCCGAATACAATCCTTCCGAATAGACTTAG|AGGGATGAGTCGCTTAGCTTATACAATTAC
GCTGACCCAGCTGGCACCCCTTCTTCTCCC|CCCGCGCATGCGCCGGGAACCACCCATGCA
AGTGGAACCCGCGCATGCGCCGGGAACCAC|ACAATTTCAATCCAGTGGCTTACCCGCCAG
GGAAGCTCCGTCCGTCACAATAGCTTATAC|CTAGTTGGTTTGCCTCATGGCTTATTCTGC
ACAATTACAATCCTTCCGAATATCAACGTG|TTCCGAATATCGTAGCTTATACAATTACAA
TCACAATAGCTTATACAATTACAATAGCTT|TCATGGCTTATTCTGCGACCAAAGGCGTCT
TAGCTTATACAATAGCTTATACAATTATAG|ATACAATTACAATCCTTCCGAATATCAACG
TCAAGACAATTTCAATCCAGTGGCTTACCC|TCAGAAGGCATGTCTAAAGGTCGGGTTTGG
TACAATTACAATCCTTCCGAATAGCTTATA|ATAAAAAGCCAGTAACTAGCACCGTTTAGT
TACAATTACAATCCTTCCGAATATAACTGG|GTGTAGTTATAGACATCAAGTCTTGGATCG
GGTTTGGGGTGCGGTCTAGCTTATACAATA|CGAATAGACTTAGCTTATACAATTACAATC
TACAATTACAATCCTTCCGAATATCGTAGC|CAATTACAATAGCTTATACAATTACAATCC
GTAACTAGCACCGTTTAGTGTAGTTATAGA|ACATCGGTGGGTTTGGTCTAGCACAGTATA
TTGGATCGAAGCCCAGTGGAACCCGCGCAT|TATTCCCCCTCAAGACAATTTCAATCCAGT
AGAGAAGGCAACATCATCACTTAGCTTATA|TCCACTTGGGTGGCAGGTGGGTATGGGCTA
TCCCCCTAGCTTATACAATTACAATCCTTC|TGCAATCGGACTCCTAGAAGTGACTGATCT
AGCTCCGTCCGTCACAATAGCTTATACAAT|GTTGGTTTGCCTCATGGCTTATTCTGCGAC
GACACGGTGCGTTTTATTTGATCCAGAGAA|GTCAAAAGCGAGGGTGTGATGGTCTCCACT
GCTCTAGACATGACCTCCTGCAAAATGGCG|CTTCTCCCCCTAGCTTATACAATTACAATC
TCCGAATAATATTCTCGCCACCGACGTCGA|ATACGGTCCGGGTGGCAGTCGCCCTACGAA
AATTTCAATCCAGTGGCTTACCCGCCAGGG|GCATGTCTAAAGGTCGGGTTTGGGGTGCGG
ACAATCCTTCCGAATACAATCCTTCCGAAT|GATGAAAGTCTGCCCGATTTTCGCTATCCC
CTCCACTTGGGTGGCAGGTGGGTATGGGCT|TCGTTCCACAAGATTCGAAATTACTACACG
GGTGGCAGTCGCCCTACGAATCTTCGAGCG|GCAACATCATCACTTAGCTTATACAATAGC
CAGACAATGGGAGCTGGAAGCTCCGTCCGT|CGCACGCCTATGATACTAGTTGGTTTGCCT
CGAATATTACAATCCTTCCGAATAACGCGT|GTGGTTAGCCGTAAATTGGAGGGAAGAGTG
TCGACAGCTACAACATCGGTGGGTTTGGTC|CTCGTAGCTTATACAATTACAATCCTTCCG
GGTGCGTTTTATTTGATCCAGAGAAGGCAA|AAGCGAGGGTGTGATGGTCTCCACTTGGGT
ATTACAATCCTTCCGAATATCGTAGCTTAT|TACAATAGCTTATACAATTACAATCCTTCC
GAATAGACTTAGCTTATACAATTACAATCC|TTATACAATTACAATCCTTCCGAATATCGT
CAATTACAATCCTTCCGAATATCCTTCCGA|GGGGGAGGGGACACGGTGCGTTTTATTTGA
CTTCCGAATAGCTTATACAATTACAATCCT|AACTAGCACCGTTTAGTGTAGTTATAGACA
CGATTGTTTTCCGATATTTCAGAAGGCATG|TATAGCTTATACAATTACAATCCTTCCGAA
ACCCGCGCATGCGCCGGGAACCACCCATGC|TCAATCCAGTGGCTTACCCGCCAGGGACTT
TGCAGGGAACTCTGCGGTCAAAAGCGAGGG|ATCGGGGTATATCACCCTGCGCGCTATCTT
ACAATCCTTCCGAATATAACTGGTGGTAAG|TATAGACATCAAGTCTTGGATCGAAGCCCA
AAATGGCGTAGCTTATACAATTACAATCCT|TTACAATCCTTCCGAATAAAAAGCCAGTAA
AGTCTGCCCGATTTTCGCTATCCCATGGGT|TTCTCGCCACCGACGTCGAACCAGGTACAG
GACGTCGAACCAGGTACAGACAATGGGAGC|CCTACGAATCTTCGAGCGCACGCCTATGAT
AGTCTTGGATCGAAGCCCAGTGGAACCCGC|CATCTATTCCCCCTCAAGACAATTTCAATC
AATAGCTTATACAATTACAATCCTTCCGAA|CACCGTTTAGTGTAGTTATAGACATCAAGT
TTCCGAATAACGCGTGACTGCAGGGAACTC|TTGGAGGGAAGAGTGCTAATCGGGGTATAT
AGCCCAGTGGAACCCGCGCATGCGCCGGGA|TCAAGACAATTTCAATCCAGTGGCTTACCC
ATCGTAGCTTATACAATTACAATCCTTCCG|TACAATCCTTCCGAATATCCTTCCGAATAC
ATATAACTGGTGGTAAGCCGTGAGCTGACC|TCTTGGATCGAAGCCCAGTGGAACCCGCGC
ATGAGTCGCTTAGCTTATACAATTACAATC|CGTCACAATAGCTTATACAATTACAATAGC
CGATTTTCGCTATCCCATGGGTCCGTATAT|ACCGACGTCGAACCAGGTACAGACAATGGG
CAATCCTTCCGAATATTATAGCTTATACAA|ATTTTCGCTATCCCATGGGTCCGTATATGC
ACTTGGGTGGCAGGTGGGTATGGGCTACCC|TCCACAAGATTCGAAATTACTACACGACTG
GCTTATACAATAGCTTATACAATTACAATC|TGGGCTACCCCAATAGTAGCGGAACCCAGC
GAATATCCTTCCGAATACGGTCCGGGTGGC|TGCGTTTTATTTGATCCAGAGAAGGCAACA
AGCCGTAAATTGGAGGGAAGAGTGCTAATC|CGGTATATACCGACTTTAAACACATCCATG
AGCTTATACAATTACAATCCTTCCGAATAA|GGACTCCTAGAAGTGACTGATCTGGTCGAC
TCCTTCCGAATACAATCCTTCCGAATATTA|AAAGTCTGCCCGATTTTCGCTATCCCATGG
TTACAATCCTTCCGAATAAAAAGCCAGTAA|AGTGACTGATCTGGTCGACAGCTACAACAT
ATAACGCGTGACTGCAGGGAACTCTGCGGT|GGAAGAGTGCTAATCGGGGTATATCACCCT
ATGGCGTAGCTTATACAATTACAATCCTTC|ACAATCCTTCCGAATAAAAAGCCAGTAACT
AATTACAATCCTTCCGAATATCCTTCCGAA|GGGGAGGGGACACGGTGCGTTTTATTTGAT
ACAATCCTTCCGAATACAATCCTTCCGAAT|TTCACACTAGGGATGAGTCGCTTAGCTTAT
GTATATGCTATTCACACTAGGGATGAGTCG|AATGGGAGCTGGAAGCTCCGTCCGTCACAA
GTGGGTTTGGTCTAGCACAGTATATTGAGC|ACAATCCTTCCGAATAAAATCCTGCGATTG
CCTTCCGAATAATATTCTCGCCACCGACGT|CGAATACGGTCCGGGTGGCAGTCGCCCTAC
TTGGAGGGAAGAGTGCTAATCGGGGTATAT|CCGACTTTAAACACATCCATGGTTCGGAAG
TATATGCTATTCACACTAGGGATGAGTCGC|ATGGGAGCTGGAAGCTCCGTCCGTCACAAT
GAATATAACTGGTGGTAAGCCGTGAGCTGA|AGTCTTGGATCGAAGCCCAGTGGAACCCGC
ATATTATAGCTTATACAATTACAATCCTTC|CCATGGGTCCGTATATGCTATTCACACTAG
TAGACTTAGCTTATACAATTACAATCCTTC|TACAATTACAATCCTTCCGAATATCGTAGC
TCCGTATATGCTATTCACACTAGGGATGAG|GACAATGGGAGCTGGAAGCTCCGTCCGTCA
TGTTTTCCGATATTTCAGAAGGCATGTCTA|GCTTATACAATTACAATCCTTCCGAATACA
ATACAATTACAATCCTTCCGAATAAAAAGC|CCTAGAAGTGACTGATCTGGTCGACAGCTA
AATCTCGTAGCTTATACAATTACAATCCTT|AGCTTATACAATTACAATCCTTCCGAATAC
TGACCTCCTGCAAAATGGCGTAGCTTATAC|TAGCTTATACAATTACAATCCTTCCGAATA
ATGTCTAAAGGTCGGGTTTGGGGTGCGGTC|GAATACAATCCTTCCGAATAGACTTAGCTT
AAAAAGCCAGTAACTAGCACCGTTTAGTGT|ACAGCTACAACATCGGTGGGTTTGGTCTAG
CAGCCCCGGTGGTTAGCCGTAAATTGGAGG|CTGACCTTTTGTTTCGGTATATACCGACTT
GCCCACCTTAGATGAAAGTCTGCCCGATTT|ATCCTTCCGAATAATATTCTCGCCACCGAC
TAGCGGAACCCAGCCCCGGTGGTTAGCCGT|GTTCTTACACCTGACCTTTTGTTTCGGTAT
GAATATTACAATCCTTCCGAATAACGCGTG|TGGTTAGCCGTAAATTGGAGGGAAGAGTGC
GGAGGGGACACGGTGCGTTTTATTTGATCC|TCTGCGGTCAAAAGCGAGGGTGTGATGGTC
ACCAAAGGCGTCTTTTGGGGGAGGGGACAC|ACGCGTGACTGCAGGGAACTCTGCGGTCAA
ATAGCTTATACAATTACAATCCTTCCGAAT|GGCGTCTTTTGGGGGAGGGGACACGGTGCG
TACAATCCTTCCGAATATTATAGCTTATAC|CGATTTTCGCTATCCCATGGGTCCGTATAT
CAACATCGGTGGGTTTGGTCTAGCACAGTA|ATACAATTACAATCCTTCCGAATAAAATCC
ATATCCTTCCGAATACGGTCCGGGTGGCAG|CGTTTTATTTGATCCAGAGAAGGCAACATC
ACTTAGCTTATACAATTACAATCCTTCCGA|AATTACAATCCTTCCGAATATCGTAGCTTA
GAATACGGTCCGGGTGGCAGTCGCCCTACG|GATCCAGAGAAGGCAACATCATCACTTAGC
CCCCTTCTTCTCCCCCTAGCTTATACAATT|GAACCACCCATGCAATCGGACTCCTAGAAG
CAATTACAATCCTTCCGAATACAATCCTTC|CCTTAGATGAAAGTCTGCCCGATTTTCGCT
GTCCGTATATGCTATTCACACTAGGGATGA|AGACAATGGGAGCTGGAAGCTCCGTCCGTC
CCAGGTACAGACAATGGGAGCTGGAAGCTC|CTTCGAGCGCACGCCTATGATACTAGTTGG
AATTACAATAGCTTATACAATTACAATCCT|GACCAAAGGCGTCTTTTGGGGGAGGGGACA
TACAATTACAATCCTTCCGAATAAAATCCT|CAATCCTTCCGAATACAATCCTTCCGAATA
TTCCGAATATTATAGCTTATACAATTACAA|GCTATCCCATGGGTCCGTATATGCTATTCA
TACCCCAATAGTAGCGGAACCCAGCCCCGG|GACTGCATATGGTTCTTACACCTGACCTTT
TTCCGAATACGGTCCGGGTGGCAGTCGCCC|ATTTGATCCAGAGAAGGCAACATCATCACT
CTGATCTGGTCGACAGCTACAACATCGGTG|GGCAAGAATCTCGTAGCTTATACAATTACA
TACTCGGGAAGGCAAGAATCTCGTAGCTTA|TAGCTTATACAATTATAGCTTATACAATTA
TTTGCCTCATGGCTTATTCTGCGACCAAAG|GAATATTACAATCCTTCCGAATAACGCGTG
AATCCTTCCGAATACAATCCTTCCGAATAG|CACACTAGGGATGAGTCGCTTAGCTTATAC
TAATATTCTCGCCACCGACGTCGAACCAGG|TCCGGGTGGCAGTCGCCCTACGAATCTTCG
ATTACAATCCTTCCGAATAATATTCTCGCC|TATCCTTCCGAATACGGTCCGGGTGGCAGT
CCGTGAGCTGACCCAGCTGGCACCCCTTCT|GTGGAACCCGCGCATGCGCCGGGAACCACC
GTTTGCCTCATGGCTTATTCTGCGACCAAA|CGAATATTACAATCCTTCCGAATAACGCGT
TATAGCTTATACAATTACAATCCTTCCGAA|GGGTCCGTATATGCTATTCACACTAGGGAT
CTTCCGAATATTATAGCTTATACAATTACA|CGCTATCCCATGGGTCCGTATATGCTATTC
TAACGCGTGACTGCAGGGAACTCTGCGGTC|GAAGAGTGCTAATCGGGGTATATCACCCTG
TCCGAATATTATAGCTTATACAATTACAAT|CTATCCCATGGGTCCGTATATGCTATTCAC
ATCCTTCCGAATATTACAATCCTTCCGAAT|AGCCCCGGTGGTTAGCCGTAAATTGGAGGG
TAGCTTATACAATTACAATCCTTCCGAATA|CAATAGTAGCGGAACCCAGCCCCGGTGGTT
ACCCAGCTGGCACCCCTTCTTCTCCCCCTA|CGCATGCGCCGGGAACCACCCATGCAATCG
GTCCGTCACAATAGCTTATACAATTACAAT|TTGCCTCATGGCTTATTCTGCGACCAAAGG
TCGTAGCTTATACAATTACAATCCTTCCGA|TATACAATTACAATCCTTCCGAATACAATC
TATCAACGTGCCCACCTTAGATGAAAGTCT|ACAATTACAATCCTTCCGAATAATATTCTC
GCGACCAAAGGCGTCTTTTGGGGGAGGGGA|ATAACGCGTGACTGCAGGGAACTCTGCGGT
GACATGACCTCCTGCAAAATGGCGTAGCTT|CCCCTAGCTTATACAATTACAATCCTTCCG
CTCGGGAAGGCAAGAATCTCGTAGCTTATA|GCTTATACAATTATAGCTTATACAATTACA
AGCTTATACAATAGCTTATACAATTACAAT|ATGGGCTACCCCAATAGTAGCGGAACCCAG
TTATTCTGCGACCAAAGGCGTCTTTTGGGG|CTTCCGAATAACGCGTGACTGCAGGGAACT
CTAGAAGTGACTGATCTGGTCGACAGCTAC|TACTCGGGAAGGCAAGAATCTCGTAGCTTA
TACAATCCTTCCGAATATCCTTCCGAATAC|GAGGGGACACGGTGCGTTTTATTTGATCCA
AATTATAGCTTATACAATTACAATCCTTCC|TATCAACGTGCCCACCTTAGATGAAAGTCT
TCCTTCCGAATAGACTTAGCTTATACAATT|GCTTAGCTTATACAATTACAATCCTTCCGA
AATATTCTCGCCACCGACGTCGAACCAGGT|CCGGGTGGCAGTCGCCCTACGAATCTTCGA
GCCCTACGAATCTTCGAGCGCACGCCTATG|CACTTAGCTTATACAATAGCTTATACAATT
ATATCGTAGCTTATACAATTACAATCCTTC|ATTACAATCCTTCCGAATATCCTTCCGAAT
AAGGCAAGAATCTCGTAGCTTATACAATTA|ACAATTATAGCTTATACAATTACAATCCTT
GGGTTTGGTCTAGCACAGTATATTGAGCAT|AATCCTTCCGAATAAAATCCTGCGATTGTT
AATATTACAATCCTTCCGAATAACGCGTGA|GGTTAGCCGTAAATTGGAGGGAAGAGTGCT
TCTAGCACAGTATATTGAGCATCTATTCCC|CGAATAAAATCCTGCGATTGTTTTCCGATA
CCCCAATAGTAGCGGAACCCAGCCCCGGTG|CTGCATATGGTTCTTACACCTGACCTTTTG
AACGTGCCCACCTTAGATGAAAGTCTGCCC|TTACAATCCTTCCGAATAATATTCTCGCCA
CAGCTGGCACCCCTTCTTCTCCCCCTAGCT|ATGCGCCGGGAACCACCCATGCAATCGGAC
AATCCTTCCGAATAAAAAGCCAGTAACTAG|ACTGATCTGGTCGACAGCTACAACATCGGT
TGGGTATGGGCTACCCCAATAGTAGCGGAA|AATTACTACACGACTGCATATGGTTCTTAC
AGCTTATACAATTACAATCCTTCCGAATAC|CGTGCCCACCTTAGATGAAAGTCTGCCCGA
GTGACTGATCTGGTCGACAGCTACAACATC|GGAAGGCAAGAATCTCGTAGCTTATACAAT
AGCTGGAAGCTCCGTCCGTCACAATAGCTT|GATACTAGTTGGTTTGCCTCATGGCTTATT
CGCTATCCCATGGGTCCGTATATGCTATTC|TCGAACCAGGTACAGACAATGGGAGCTGGA
GAATCTCGTAGCTTATACAATTACAATCCT|TAGCTTATACAATTACAATCCTTCCGAATA
GCGTCTTTTGGGGGAGGGGACACGGTGCGT|ACTGCAGGGAACTCTGCGGTCAAAAGCGAG
GTGTGATGGTCTCCACTTGGGTGGCAGGTG|TAGATTCGATTCGTTCCACAAGATTCGAAA
CGGTCTAGCTTATACAATAGCTTATACAAT|AGCTTATACAATTACAATCCTTCCGAATAT
CTCATGGCTTATTCTGCGACCAAAGGCGTC|TTACAATCCTTCCGAATAACGCGTGACTGC
ACACTAGGGATGAGTCGCTTAGCTTATACA|AGCTCCGTCCGTCACAATAGCTTATACAAT
AATATCCTTCCGAATACGGTCCGGGTGGCA|GCGTTTTATTTGATCCAGAGAAGGCAACAT
GCACCGTTTAGTGTAGTTATAGACATCAAG|TGGGTTTGGTCTAGCACAGTATATTGAGCA
GAATATCGTAGCTTATACAATTACAATCCT|CAATTACAATCCTTCCGAATATCCTTCCGA
TTCCGAATACAATCCTTCCGAATAGACTTA|TAGGGATGAGTCGCTTAGCTTATACAATTA
CCCACCTTAGATGAAAGTCTGCCCGATTTT|TCCTTCCGAATAATATTCTCGCCACCGACG
AAAATGGCGTAGCTTATACAATTACAATCC|ATTACAATCCTTCCGAATAAAAAGCCAGTA
ACGTGCCCACCTTAGATGAAAGTCTGCCCG|TACAATCCTTCCGAATAATATTCTCGCCAC
TTAGCTTATACAATTACAATCCTTCCGAAT|AGCTTATACAATTACAATAGCTTATACAAT
AATAACGCGTGACTGCAGGGAACTCTGCGG|GGGAAGAGTGCTAATCGGGGTATATCACCC
AGCTTATACAATTACAATCCTTCCGAATAC|TCCGTATATGCTATTCACACTAGGGATGAG
CGGGAAGGCAAGAATCTCGTAGCTTATACA|TTATACAATTATAGCTTATACAATTACAAT
TGGGGGAGGGGACACGGTGCGTTTTATTTG|GAACTCTGCGGTCAAAAGCGAGGGTGTGAT
TATACAATTACAATCCTTCCGAATACAATC|TATATGCTATTCACACTAGGGATGAGTCGC
ACAATTACAATCCTTCCGAATATAACTGGT|TGTAGTTATAGACATCAAGTCTTGGATCGA
CAATTACAATCCTTCCGAATATTACAATCC|CGGAACCCAGCCCCGGTGGTTAGCCGTAAA
TGGTCGACAGCTACAACATCGGTGGGTTTG|AATCTCGTAGCTTATACAATTACAATCCTT
CTTATACAATTACAATCCTTCCGAATAATA|CTTCCGAATATCCTTCCGAATACGGTCCGG
TCTAGACATGACCTCCTGCAAAATGGCGTA|TCTCCCCCTAGCTTATACAATTACAATCCT
TATACAATTATAGCTTATACAATTACAATC|CCGAATATCAACGTGCCCACCTTAGATGAA
CAATCCTTCCGAATAAAAAGCCAGTAACTA|GACTGATCTGGTCGACAGCTACAACATCGG
ATCCTTCCGAATAAAATCCTGCGATTGTTT|GAATACAATCCTTCCGAATATTATAGCTTA
CATGGGTCCGTATATGCTATTCACACTAGG|GGTACAGACAATGGGAGCTGGAAGCTCCGT
CAGAGAAGGCAACATCATCACTTAGCTTAT|CTCCACTTGGGTGGCAGGTGGGTATGGGCT
GACTGATCTGGTCGACAGCTACAACATCGG|AAGGCAAGAATCTCGTAGCTTATACAATTA
CTCCGTCCGTCACAATAGCTTATACAATTA|TGGTTTGCCTCATGGCTTATTCTGCGACCA
GTGCCCACCTTAGATGAAAGTCTGCCCGAT|CAATCCTTCCGAATAATATTCTCGCCACCG
CGCCGGGAACCACCCATGCAATCGGACTCC|GCTTACCCGCCAGGGACTTCATGCTGTTTT
ATCTGGTCGACAGCTACAACATCGGTGGGT|AAGAATCTCGTAGCTTATACAATTACAATC
AATAAAATCCTGCGATTGTTTTCCGATATT|CCTTCCGAATATTATAGCTTATACAATTAC
CGGTCCGGGTGGCAGTCGCCCTACGAATCT|AGAGAAGGCAACATCATCACTTAGCTTATA
TCTATTCCCCCTCAAGACAATTTCAATCCA|TTTCCGATATTTCAGAAGGCATGTCTAAAG
ATCTTCGAGCGCACGCCTATGATACTAGTT|TATACAATAGCTTATACAATTACAATCCTT
CTTATACAATTACAATAGCTTATACAATTA|ATTCTGCGACCAAAGGCGTCTTTTGGGGGA
GAATAAAATCCTGCGATTGTTTTCCGATAT|TCCTTCCGAATATTATAGCTTATACAATTA
GCGTTTTATTTGATCCAGAGAAGGCAACAT|CGAGGGTGTGATGGTCTCCACTTGGGTGGC
CTAGCTTATACAATAGCTTATACAATTATA|TATACAATTACAATCCTTCCGAATATCAAC
TCCTGCGATTGTTTTCCGATATTTCAGAAG|AATATTATAGCTTATACAATTACAATCCTT
GACAATTTCAATCCAGTGGCTTACCCGCCA|AAGGCATGTCTAAAGGTCGGGTTTGGGGTG
TGGGGTGCGGTCTAGCTTATACAATAGCTT|TAGACTTAGCTTATACAATTACAATCCTTC
GGTGGTAAGCCGTGAGCTGACCCAGCTGGC|CGAAGCCCAGTGGAACCCGCGCATGCGCCG
CGAATAGCTTATACAATTACAATCCTTCCG|AGCACCGTTTAGTGTAGTTATAGACATCAA
GCGTGACTGCAGGGAACTCTGCGGTCAAAA|AGTGCTAATCGGGGTATATCACCCTGCGCG
ATATTTCAGAAGGCATGTCTAAAGGTCGGG|ATTACAATCCTTCCGAATACAATCCTTCCG
CAATCCTTCCGAATAGACTTAGCTTATACA|GTCGCTTAGCTTATACAATTACAATCCTTC
GTAAGCCGTGAGCTGACCCAGCTGGCACCC|GCCCAGTGGAACCCGCGCATGCGCCGGGAA
GAAGGCAACATCATCACTTAGCTTATACAA|ACTTGGGTGGCAGGTGGGTATGGGCTACCC
TATACAATTACAATCCTTCCGAATATAACT|TAGTGTAGTTATAGACATCAAGTCTTGGAT
ACAATCCTTCCGAATAATATTCTCGCCACC|CCTTCCGAATACGGTCCGGGTGGCAGTCGC
TTTCCGATATTTCAGAAGGCATGTCTAAAG|TATACAATTACAATCCTTCCGAATACAATC
TGAGCTGACCCAGCTGGCACCCCTTCTTCT|GAACCCGCGCATGCGCCGGGAACCACCCAT
TCCTTCCGAATAGCTTATACAATTACAATC|GTAACTAGCACCGTTTAGTGTAGTTATAGA
TTTGGGGGAGGGGACACGGTGCGTTTTATT|GGGAACTCTGCGGTCAAAAGCGAGGGTGTG
ACAATTACAATAGCTTATACAATTACAATC|GCGACCAAAGGCGTCTTTTGGGGGAGGGGA
GGAACCCGCGCATGCGCCGGGAACCACCCA|ATTTCAATCCAGTGGCTTACCCGCCAGGGA
TGACTGCAGGGAACTCTGCGGTCAAAAGCG|GCTAATCGGGGTATATCACCCTGCGCGCTA
CGTATATGCTATTCACACTAGGGATGAGTC|CAATGGGAGCTGGAAGCTCCGTCCGTCACA
CCCCTCAAGACAATTTCAATCCAGTGGCTT|TATTTCAGAAGGCATGTCTAAAGGTCGGGT
TGGGAGCTGGAAGCTCCGTCCGTCACAATA|CTATGATACTAGTTGGTTTGCCTCATGGCT
ACAATGGGAGCTGGAAGCTCCGTCCGTCAC|ACGCCTATGATACTAGTTGGTTTGCCTCAT
TCGCCACCGACGTCGAACCAGGTACAGACA|GCAGTCGCCCTACGAATCTTCGAGCGCACG
TTTTGGGGGAGGGGACACGGTGCGTTTTAT|AGGGAACTCTGCGGTCAAAAGCGAGGGTGT
TTATACAATTACAATCCTTCCGAATATTAC|AGTAGCGGAACCCAGCCCCGGTGGTTAGCC
AACCAGGTACAGACAATGGGAGCTGGAAGC|ATCTTCGAGCGCACGCCTATGATACTAGTT
AATCCTTCCGAATATCAACGTGCCCACCTT|ATCGTAGCTTATACAATTACAATCCTTCCG
CAATAGTAGCGGAACCCAGCCCCGGTGGTT|CATATGGTTCTTACACCTGACCTTTTGTTT
TGGAAGCTCCGTCCGTCACAATAGCTTATA|ACTAGTTGGTTTGCCTCATGGCTTATTCTG
GGTGGGTTTGGTCTAGCACAGTATATTGAG|TACAATCCTTCCGAATAAAATCCTGCGATT
CAGTATATTGAGCATCTATTCCCCCTCAAG|AATCCTGCGATTGTTTTCCGATATTTCAGA
GCTTATACAATTACAATCCTTCCGAATATC|CAATCCTTCCGAATATCGTAGCTTATACAA
TTCCGAATAAAAAGCCAGTAACTAGCACCG|TCTGGTCGACAGCTACAACATCGGTGGGTT
TCAATCCAGTGGCTTACCCGCCAGGGACTT|GTCTAAAGGTCGGGTTTGGGGTGCGGTCTA
GTGGCAGTCGCCCTACGAATCTTCGAGCGC|CAACATCATCACTTAGCTTATACAATAGCT
AATTACAATCCTTCCGAATAATATTCTCGC|ATATCCTTCCGAATACGGTCCGGGTGGCAG
GTCTAGCTTATACAATAGCTTATACAATTA|CTTATACAATTACAATCCTTCCGAATATCA
CCCGCCAGGGACTTCATGCTGTTTTACTCG|TGGGGTGCGGTCTAGCTTATACAATAGCTT
CTTGGGTGGCAGGTGGGTATGGGCTACCCC|CCACAAGATTCGAAATTACTACACGACTGC
TAGCCGTAAATTGGAGGGAAGAGTGCTAAT|TCGGTATATACCGACTTTAAACACATCCAT
TGCTGTTTTACTCGGGAAGGCAAGAATCTC|TTATACAATAGCTTATACAATTATAGCTTA
AATAGCTTATACAATTACAATAGCTTATAC|GGCTTATTCTGCGACCAAAGGCGTCTTTTG
CTCCTAGAAGTGACTGATCTGGTCGACAGC|TTTTACTCGGGAAGGCAAGAATCTCGTAGC
AAAAGCCAGTAACTAGCACCGTTTAGTGTA|CAGCTACAACATCGGTGGGTTTGGTCTAGC
TCCTTCCGAATATAACTGGTGGTAAGCCGT|GACATCAAGTCTTGGATCGAAGCCCAGTGG
GGGGAGGGGACACGGTGCGTTTTATTTGAT|ACTCTGCGGTCAAAAGCGAGGGTGTGATGG
ACTGGTGGTAAGCCGTGAGCTGACCCAGCT|GATCGAAGCCCAGTGGAACCCGCGCATGCG
CGGTGCGTTTTATTTGATCCAGAGAAGGCA|AAAGCGAGGGTGTGATGGTCTCCACTTGGG
CCAGTAACTAGCACCGTTTAGTGTAGTTAT|ACAACATCGGTGGGTTTGGTCTAGCACAGT
ACAATCCTTCCGAATAAAATCCTGCGATTG|TCCGAATACAATCCTTCCGAATATTATAGC
CGAACCAGGTACAGACAATGGGAGCTGGAA|GAATCTTCGAGCGCACGCCTATGATACTAG
CAATCCTTCCGAATAATATTCTCGCCACCG|CTTCCGAATACGGTCCGGGTGGCAGTCGCC
AATTACAATCCTTCCGAATATTACAATCCT|GGAACCCAGCCCCGGTGGTTAGCCGTAAAT
CTTATACAATTACAATCCTTCCGAATACAA|TGCCCACCTTAGATGAAAGTCTGCCCGATT
TCCTTCCGAATACGGTCCGGGTGGCAGTCG|TTTATTTGATCCAGAGAAGGCAACATCATC
GGGGACACGGTGCGTTTTATTTGATCCAGA|GCGGTCAAAAGCGAGGGTGTGATGGTCTCC
TTTCAGAAGGCATGTCTAAAGGTCGGGTTT|ACAATCCTTCCGAATACAATCCTTCCGAAT
GTGACTGCAGGGAACTCTGCGGTCAAAAGC|TGCTAATCGGGGTATATCACCCTGCGCGCT
ATGGGCTACCCCAATAGTAGCGGAACCCAG|CTACACGACTGCATATGGTTCTTACACCTG
AGATGAAAGTCTGCCCGATTTTCGCTATCC|AATAATATTCTCGCCACCGACGTCGAACCA
TAGATGAAAGTCTGCCCGATTTTCGCTATC|GAATAATATTCTCGCCACCGACGTCGAACC
TTCCGAATACAATCCTTCCGAATATTATAG|GTCTGCCCGATTTTCGCTATCCCATGGGTC
CAATTACAATCCTTCCGAATATCGTAGCTT|ATTACAATAGCTTATACAATTACAATCCTT
ATTACAATAGCTTATACAATTACAATCCTT|ACCAAAGGCGTCTTTTGGGGGAGGGGACAC
TCAGAAGGCATGTCTAAAGGTCGGGTTTGG|AATCCTTCCGAATACAATCCTTCCGAATAG
GTTTAGTGTAGTTATAGACATCAAGTCTTG|TTGGTCTAGCACAGTATATTGAGCATCTAT
ATTACAATCCTTCCGAATATCCTTCCGAAT|GGGAGGGGACACGGTGCGTTTTATTTGATC
TAGCTTATACAATTACAATCCTTCCGAATA|ACAATTACAATCCTTCCGAATACAATCCTT
TTCCGAATAATATTCTCGCCACCGACGTCG|AATACGGTCCGGGTGGCAGTCGCCCTACGA
GCAGGGAACTCTGCGGTCAAAAGCGAGGGT|TCGGGGTATATCACCCTGCGCGCTATCTTA
TACAATTACAATCCTTCCGAATACAATCCT|TATGCTATTCACACTAGGGATGAGTCGCTT
TACAATTACAATCCTTCCGAATAATATTCT|CGAATATCCTTCCGAATACGGTCCGGGTGG
CCATGGGTCCGTATATGCTATTCACACTAG|AGGTACAGACAATGGGAGCTGGAAGCTCCG
ACTAGCACCGTTTAGTGTAGTTATAGACAT|TCGGTGGGTTTGGTCTAGCACAGTATATTG
GGCTTATTCTGCGACCAAAGGCGTCTTTTG|ATCCTTCCGAATAACGCGTGACTGCAGGGA
CCAATAGTAGCGGAACCCAGCCCCGGTGGT|GCATATGGTTCTTACACCTGACCTTTTGTT
ACAATTTCAATCCAGTGGCTTACCCGCCAG|AGGCATGTCTAAAGGTCGGGTTTGGGGTGC
CTGGTGGTAAGCCGTGAGCTGACCCAGCTG|ATCGAAGCCCAGTGGAACCCGCGCATGCGC
TATCGTAGCTTATACAATTACAATCCTTCC|TTACAATCCTTCCGAATATCCTTCCGAATA
GCGTAGCTTATACAATTACAATCCTTCCGA|ATCCTTCCGAATAAAAAGCCAGTAACTAGC
ATAAAAAGCCAGTAACTAGCACCGTTTAGT|CGACAGCTACAACATCGGTGGGTTTGGTCT
TACAATTACAATCCTTCCGAATACAATCCT|CACCTTAGATGAAAGTCTGCCCGATTTTCG
TTATTTGATCCAGAGAAGGCAACATCATCA|GTGTGATGGTCTCCACTTGGGTGGCAGGTG
TACAATCCTTCCGAATAAAATCCTGCGATT|TTCCGAATACAATCCTTCCGAATATTATAG
CCCAGTGGAACCCGCGCATGCGCCGGGAAC|AAGACAATTTCAATCCAGTGGCTTACCCGC
ATGGGAGCTGGAAGCTCCGTCCGTCACAAT|CCTATGATACTAGTTGGTTTGCCTCATGGC
AGCGGAACCCAGCCCCGGTGGTTAGCCGTA|TTCTTACACCTGACCTTTTGTTTCGGTATA
GAGCATCTATTCCCCCTCAAGACAATTTCA|ATTGTTTTCCGATATTTCAGAAGGCATGTC
AGCCCCGGTGGTTAGCCGTAAATTGGAGGG|TGACCTTTTGTTTCGGTATATACCGACTTT
TGCGCCGGGAACCACCCATGCAATCGGACT|TGGCTTACCCGCCAGGGACTTCATGCTGTT
ATCTCGTAGCTTATACAATTACAATCCTTC|GCTTATACAATTACAATCCTTCCGAATACA
CAAAATGGCGTAGCTTATACAATTACAATC|AATTACAATCCTTCCGAATAAAAAGCCAGT
AATTACAATCCTTCCGAATAGCTTATACAA|AAAAGCCAGTAACTAGCACCGTTTAGTGTA
TAGCACAGTATATTGAGCATCTATTCCCCC|AATAAAATCCTGCGATTGTTTTCCGATATT
GCTTATACAATTACAATCCTTCCGAATACA|CCGTATATGCTATTCACACTAGGGATGAGT
ATCACTTAGCTTATACAATAGCTTATACAA|GGTGGGTATGGGCTACCCCAATAGTAGCGG
TATTGAGCATCTATTCCCCCTCAAGACAAT|TGCGATTGTTTTCCGATATTTCAGAAGGCA
CATCACTTAGCTTATACAATAGCTTATACA|AGGTGGGTATGGGCTACCCCAATAGTAGCG
TCTCCCCCTAGCTTATACAATTACAATCCT|CATGCAATCGGACTCCTAGAAGTGACTGAT
TAACTAGCACCGTTTAGTGTAGTTATAGAC|CATCGGTGGGTTTGGTCTAGCACAGTATAT
CAATTATAGCTTATACAATTACAATCCTTC|ATATCAACGTGCCCACCTTAGATGAAAGTC
CACTTGGGTGGCAGGTGGGTATGGGCTACC|TTCCACAAGATTCGAAATTACTACACGACT
GCACAGTATATTGAGCATCTATTCCCCCTC|TAAAATCCTGCGATTGTTTTCCGATATTTC
CCACCTTAGATGAAAGTCTGCCCGATTTTC|CCTTCCGAATAATATTCTCGCCACCGACGT
CTTATACAATTATAGCTTATACAATTACAA|TTCCGAATATCAACGTGCCCACCTTAGATG
TTATACAATTACAATCCTTCCGAATATCGT|ATACAATTACAATAGCTTATACAATTACAA
GAATACAATCCTTCCGAATATTATAGCTTA|GCCCGATTTTCGCTATCCCATGGGTCCGTA
AGCCGTGAGCTGACCCAGCTGGCACCCCTT|CAGTGGAACCCGCGCATGCGCCGGGAACCA
CAATCCTTCCGAATATCGTAGCTTATACAA|ATAGCTTATACAATTACAATCCTTCCGAAT
CTAGCACCGTTTAGTGTAGTTATAGACATC|CGGTGGGTTTGGTCTAGCACAGTATATTGA
TATCCTTCCGAATACGGTCCGGGTGGCAGT|GTTTTATTTGATCCAGAGAAGGCAACATCA
TCTCGTAGCTTATACAATTACAATCCTTCC|CTTATACAATTACAATCCTTCCGAATACAA
TTACCCGCCAGGGACTTCATGCTGTTTTAC|GTTTGGGGTGCGGTCTAGCTTATACAATAG
GATATTTCAGAAGGCATGTCTAAAGGTCGG|AATTACAATCCTTCCGAATACAATCCTTCC
TTATACAATTACAATCCTTCCGAATACAAT|GCCCACCTTAGATGAAAGTCTGCCCGATTT
AATAGCTTATACAATTACAATCCTTCCGAA|AGGCGTCTTTTGGGGGAGGGGACACGGTGC
GATGAGTCGCTTAGCTTATACAATTACAAT|CCGTCACAATAGCTTATACAATTACAATAG
GTATATTGAGCATCTATTCCCCCTCAAGAC|TCCTGCGATTGTTTTCCGATATTTCAGAAG
CCGCGCATGCGCCGGGAACCACCCATGCAA|AATCCAGTGGCTTACCCGCCAGGGACTTCA
GAGCTGACCCAGCTGGCACCCCTTCTTCTC|AACCCGCGCATGCGCCGGGAACCACCCATG
CGTGCCCACCTTAGATGAAAGTCTGCCCGA|ACAATCCTTCCGAATAATATTCTCGCCACC
TTATACAATTACAATCCTTCCGAATATAAC|TTAGTGTAGTTATAGACATCAAGTCTTGGA
GAAGCTCCGTCCGTCACAATAGCTTATACA|TAGTTGGTTTGCCTCATGGCTTATTCTGCG
TGGCTTATTCTGCGACCAAAGGCGTCTTTT|AATCCTTCCGAATAACGCGTGACTGCAGGG
CAATCCTTCCGAATAAAATCCTGCGATTGT|CCGAATACAATCCTTCCGAATATTATAGCT
AGTATATTGAGCATCTATTCCCCCTCAAGA|ATCCTGCGATTGTTTTCCGATATTTCAGAA
CTGGCACCCCTTCTTCTCCCCCTAGCTTAT|CGCCGGGAACCACCCATGCAATCGGACTCC
ATCTATTCCCCCTCAAGACAATTTCAATCC|TTTTCCGATATTTCAGAAGGCATGTCTAAA
CTTGGATCGAAGCCCAGTGGAACCCGCGCA|CTATTCCCCCTCAAGACAATTTCAATCCAG
ATCCTTCCGAATAATATTCTCGCCACCGAC|TCCGAATACGGTCCGGGTGGCAGTCGCCCT
CGTAGCTTATACAATTACAATCCTTCCGAA|ATACAATTACAATCCTTCCGAATACAATCC
AAGTCTGCCCGATTTTCGCTATCCCATGGG|ATTCTCGCCACCGACGTCGAACCAGGTACA
CCGCCAGGGACTTCATGCTGTTTTACTCGG|GGGGTGCGGTCTAGCTTATACAATAGCTTA
TCCGAATAGCTTATACAATTACAATCCTTC|CTAGCACCGTTTAGTGTAGTTATAGACATC
ATCCTTCCGAATATAACTGGTGGTAAGCCG|AGACATCAAGTCTTGGATCGAAGCCCAGTG
GTAGCTTATACAATTACAATCCTTCCGAAT|CCTTCCGAATAAAAAGCCAGTAACTAGCAC
TTACAATCCTTCCGAATAAAATCCTGCGAT|CTTCCGAATACAATCCTTCCGAATATTATA
TTCCGAATAGCTTATACAATTACAATCCTT|ACTAGCACCGTTTAGTGTAGTTATAGACAT
GCAAAATGGCGTAGCTTATACAATTACAAT|CAATTACAATCCTTCCGAATAAAAAGCCAG
TCGGACTCCTAGAAGTGACTGATCTGGTCG|TGCTGTTTTACTCGGGAAGGCAAGAATCTC
GGACACGGTGCGTTTTATTTGATCCAGAGA|GGTCAAAAGCGAGGGTGTGATGGTCTCCAC
TTGTTTTCCGATATTTCAGAAGGCATGTCT|AGCTTATACAATTACAATCCTTCCGAATAC
CTTATACAATTACAATCCTTCCGAATATAA|TTTAGTGTAGTTATAGACATCAAGTCTTGG
TTAGTGTAGTTATAGACATCAAGTCTTGGA|GGTCTAGCACAGTATATTGAGCATCTATTC
CCGAATATTATAGCTTATACAATTACAATC|TATCCCATGGGTCCGTATATGCTATTCACA
GAATAATATTCTCGCCACCGACGTCGAACC|CGGTCCGGGTGGCAGTCGCCCTACGAATCT
CCGAATACAATCCTTCCGAATATTATAGCT|CTGCCCGATTTTCGCTATCCCATGGGTCCG
ATGCAATCGGACTCCTAGAAGTGACTGATC|ACTTCATGCTGTTTTACTCGGGAAGGCAAG
GACAGCTACAACATCGGTGGGTTTGGTCTA|CGTAGCTTATACAATTACAATCCTTCCGAA
TGCTATTCACACTAGGGATGAGTCGCTTAG|GAGCTGGAAGCTCCGTCCGTCACAATAGCT
ATCAACGTGCCCACCTTAGATGAAAGTCTG|CAATTACAATCCTTCCGAATAATATTCTCG
CGTCACAATAGCTTATACAATTACAATAGC|CCTCATGGCTTATTCTGCGACCAAAGGCGT
GGCAAGAATCTCGTAGCTTATACAATTACA|AATTATAGCTTATACAATTACAATCCTTCC
TATTTCAGAAGGCATGTCTAAAGGTCGGGT|TTACAATCCTTCCGAATACAATCCTTCCGA
GCTCCGTCCGTCACAATAGCTTATACAATT|TTGGTTTGCCTCATGGCTTATTCTGCGACC
TCATCACTTAGCTTATACAATAGCTTATAC|CAGGTGGGTATGGGCTACCCCAATAGTAGC
GCTTACCCGCCAGGGACTTCATGCTGTTTT|GGGTTTGGGGTGCGGTCTAGCTTATACAAT
TTATAGACATCAAGTCTTGGATCGAAGCCC|CAGTATATTGAGCATCTATTCCCCCTCAAG
GTTTTCCGATATTTCAGAAGGCATGTCTAA|CTTATACAATTACAATCCTTCCGAATACAA
GTTTTATTTGATCCAGAGAAGGCAACATCA|AGGGTGTGATGGTCTCCACTTGGGTGGCAG
AATTACAATCCTTCCGAATAAAATCCTGCG|TCCTTCCGAATACAATCCTTCCGAATATTA
GCTTATACAATAGCTTATACAATTATAGCT|ACAATTACAATCCTTCCGAATATCAACGTG
GATGAAAGTCTGCCCGATTTTCGCTATCCC|ATAATATTCTCGCCACCGACGTCGAACCAG
TCTGCGACCAAAGGCGTCTTTTGGGGGAGG|CGAATAACGCGTGACTGCAGGGAACTCTGC
GACTTAGCTTATACAATTACAATCCTTCCG|CAATTACAATCCTTCCGAATATCGTAGCTT
GCCTCATGGCTTATTCTGCGACCAAAGGCG|TATTACAATCCTTCCGAATAACGCGTGACT
ATGAAAGTCTGCCCGATTTTCGCTATCCCA|TAATATTCTCGCCACCGACGTCGAACCAGG
CTTCCGAATAAAATCCTGCGATTGTTTTCC|TACAATCCTTCCGAATATTATAGCTTATAC
GGGTATGGGCTACCCCAATAGTAGCGGAAC|ATTACTACACGACTGCATATGGTTCTTACA
ATAGCTTATACAATTACAATCCTTCCGAAT|GGTCCGTATATGCTATTCACACTAGGGATG
AATTACAATCCTTCCGAATATAACTGGTGG|TAGTTATAGACATCAAGTCTTGGATCGAAG
CCTTCCGAATAAAAAGCCAGTAACTAGCAC|GATCTGGTCGACAGCTACAACATCGGTGGG
ATACAATTACAATCCTTCCGAATACAATCC|CCACCTTAGATGAAAGTCTGCCCGATTTTC
CGAGGGTGTGATGGTCTCCACTTGGGTGGC|TATCTTAGATTCGATTCGTTCCACAAGATT
TTCCGATATTTCAGAAGGCATGTCTAAAGG|ATACAATTACAATCCTTCCGAATACAATCC
TCCAGAGAAGGCAACATCATCACTTAGCTT|GTCTCCACTTGGGTGGCAGGTGGGTATGGG
GCGCCGGGAACCACCCATGCAATCGGACTC|GGCTTACCCGCCAGGGACTTCATGCTGTTT
ATTATAGCTTATACAATTACAATCCTTCCG|ATGGGTCCGTATATGCTATTCACACTAGGG
CAATTACAATCCTTCCGAATATCAACGTGC|TCCGAATATCGTAGCTTATACAATTACAAT
TCTCCACTTGGGTGGCAGGTGGGTATGGGC|TTCGTTCCACAAGATTCGAAATTACTACAC
TTACAATCCTTCCGAATATCAACGTGCCCA|GAATATCGTAGCTTATACAATTACAATCCT
CACGGTGCGTTTTATTTGATCCAGAGAAGG|CAAAAGCGAGGGTGTGATGGTCTCCACTTG
GTCGCTTAGCTTATACAATTACAATCCTTC|ACAATAGCTTATACAATTACAATAGCTTAT
ATATTCTCGCCACCGACGTCGAACCAGGTA|CGGGTGGCAGTCGCCCTACGAATCTTCGAG
TGGTTAGCCGTAAATTGGAGGGAAGAGTGC|TGTTTCGGTATATACCGACTTTAAACACAT
CTTCGAGCGCACGCCTATGATACTAGTTGG|TACAATAGCTTATACAATTACAATCCTTCC
AAAAGCGAGGGTGTGATGGTCTCCACTTGG|CGCGCTATCTTAGATTCGATTCGTTCCACA
GCCACCGACGTCGAACCAGGTACAGACAAT|AGTCGCCCTACGAATCTTCGAGCGCACGCC
AATAAAAAGCCAGTAACTAGCACCGTTTAG|TCGACAGCTACAACATCGGTGGGTTTGGTC
GTGCGTTTTATTTGATCCAGAGAAGGCAAC|AGCGAGGGTGTGATGGTCTCCACTTGGGTG
CTTCTCCCCCTAGCTTATACAATTACAATC|CCCATGCAATCGGACTCCTAGAAGTGACTG
TGAAAGTCTGCCCGATTTTCGCTATCCCAT|AATATTCTCGCCACCGACGTCGAACCAGGT
CTCCTGCAAAATGGCGTAGCTTATACAATT|TTATACAATTACAATCCTTCCGAATAAAAA
GTGAGCTGACCCAGCTGGCACCCCTTCTTC|GGAACCCGCGCATGCGCCGGGAACCACCCA
GAATACAATCCTTCCGAATAGACTTAGCTT|GATGAGTCGCTTAGCTTATACAATTACAAT
GTCAAAAGCGAGGGTGTGATGGTCTCCACT|CTGCGCGCTATCTTAGATTCGATTCGTTCC
CCGACGTCGAACCAGGTACAGACAATGGGA|GCCCTACGAATCTTCGAGCGCACGCCTATG
ATGGTCTCCACTTGGGTGGCAGGTGGGTAT|TCGATTCGTTCCACAAGATTCGAAATTACT
AGCTTATACAATAGCTTATACAATTATAGC|TACAATTACAATCCTTCCGAATATCAACGT
TGGCAGGTGGGTATGGGCTACCCCAATAGT|GATTCGAAATTACTACACGACTGCATATGG
AGGTACAGACAATGGGAGCTGGAAGCTCCG|TCGAGCGCACGCCTATGATACTAGTTGGTT
ATCCTTCCGAATATCAACGTGCCCACCTTA|TCGTAGCTTATACAATTACAATCCTTCCGA
TAGCTTATACAATTACAATCCTTCCGAATA|TACAATCCTTCCGAATATCGTAGCTTATAC
TTACAATCCTTCCGAATACAATCCTTCCGA|TAGATGAAAGTCTGCCCGATTTTCGCTATC
CAATCCTTCCGAATACAATCCTTCCGAATA|ATGAAAGTCTGCCCGATTTTCGCTATCCCA
TGGTGGTAAGCCGTGAGCTGACCCAGCTGG|TCGAAGCCCAGTGGAACCCGCGCATGCGCC
GCGAGGGTGTGATGGTCTCCACTTGGGTGG|CTATCTTAGATTCGATTCGTTCCACAAGAT
GGTTTGCCTCATGGCTTATTCTGCGACCAA|CCGAATATTACAATCCTTCCGAATAACGCG
CCTTCCGAATACAATCCTTCCGAATATTAT|AAGTCTGCCCGATTTTCGCTATCCCATGGG
TACAATCCTTCCGAATACAATCCTTCCGAA|ATTCACACTAGGGATGAGTCGCTTAGCTTA
GGGATGAGTCGCTTAGCTTATACAATTACA|GTCCGTCACAATAGCTTATACAATTACAAT
AGGGTGTGATGGTCTCCACTTGGGTGGCAG|TCTTAGATTCGATTCGTTCCACAAGATTCG
ACTTCATGCTGTTTTACTCGGGAAGGCAAG|TCTAGCTTATACAATAGCTTATACAATTAT
GTGTAGTTATAGACATCAAGTCTTGGATCG|CTAGCACAGTATATTGAGCATCTATTCCCC
TAGCACCGTTTAGTGTAGTTATAGACATCA|GGTGGGTTTGGTCTAGCACAGTATATTGAG
ATTTGATCCAGAGAAGGCAACATCATCACT|GTGATGGTCTCCACTTGGGTGGCAGGTGGG
CTTAGCTTATACAATAGCTTATACAATTAC|GGTATGGGCTACCCCAATAGTAGCGGAACC
TGACCCAGCTGGCACCCCTTCTTCTCCCCC|CGCGCATGCGCCGGGAACCACCCATGCAAT
TATTTGATCCAGAGAAGGCAACATCATCAC|TGTGATGGTCTCCACTTGGGTGGCAGGTGG
CGTGACTGCAGGGAACTCTGCGGTCAAAAG|GTGCTAATCGGGGTATATCACCCTGCGCGC
CCTTCCGAATATTATAGCTTATACAATTAC|TCGCTATCCCATGGGTCCGTATATGCTATT
GAGTCGCTTAGCTTATACAATTACAATCCT|TCACAATAGCTTATACAATTACAATAGCTT
TAAAATCCTGCGATTGTTTTCCGATATTTC|TTCCGAATATTATAGCTTATACAATTACAA
GACCCAGCTGGCACCCCTTCTTCTCCCCCT|GCGCATGCGCCGGGAACCACCCATGCAATC
GAAAGTCTGCCCGATTTTCGCTATCCCATG|ATATTCTCGCCACCGACGTCGAACCAGGTA
TACAATCCTTCCGAATACAATCCTTCCGAA|AGATGAAAGTCTGCCCGATTTTCGCTATCC
ATTACAATCCTTCCGAATAAAATCCTGCGA|CCTTCCGAATACAATCCTTCCGAATATTAT
AGTAACTAGCACCGTTTAGTGTAGTTATAG|AACATCGGTGGGTTTGGTCTAGCACAGTAT
CTGCGATTGTTTTCCGATATTTCAGAAGGC|TATTATAGCTTATACAATTACAATCCTTCC
TGTCTAAAGGTCGGGTTTGGGGTGCGGTCT|AATACAATCCTTCCGAATAGACTTAGCTTA
ATGATACTAGTTGGTTTGCCTCATGGCTTA|ATTACAATCCTTCCGAATATTACAATCCTT
TTGCCTCATGGCTTATTCTGCGACCAAAGG|AATATTACAATCCTTCCGAATAACGCGTGA
CCCCCTAGCTTATACAATTACAATCCTTCC|GCAATCGGACTCCTAGAAGTGACTGATCTG
CGAATAGACTTAGCTTATACAATTACAATC|CTTATACAATTACAATCCTTCCGAATATCG
CGGGAACCACCCATGCAATCGGACTCCTAG|TACCCGCCAGGGACTTCATGCTGTTTTACT
TTCCGAATATCAACGTGCCCACCTTAGATG|AGCTTATACAATTACAATCCTTCCGAATAA
GCACGCCTATGATACTAGTTGGTTTGCCTC|CTTATACAATTACAATCCTTCCGAATATTA
TTGGGGGAGGGGACACGGTGCGTTTTATTT|GGAACTCTGCGGTCAAAAGCGAGGGTGTGA
GGCGTAGCTTATACAATTACAATCCTTCCG|AATCCTTCCGAATAAAAAGCCAGTAACTAG
AGCTTATACAATTACAATAGCTTATACAAT|TTATTCTGCGACCAAAGGCGTCTTTTGGGG
GGTCCGGGTGGCAGTCGCCCTACGAATCTT|GAGAAGGCAACATCATCACTTAGCTTATAC
ACAATTACAATCCTTCCGAATAAAATCCTG|AATCCTTCCGAATACAATCCTTCCGAATAT
TAACTGGTGGTAAGCCGTGAGCTGACCCAG|TGGATCGAAGCCCAGTGGAACCCGCGCATG
TTTTACTCGGGAAGGCAAGAATCTCGTAGC|CAATAGCTTATACAATTATAGCTTATACAA
GTTGGTTTGCCTCATGGCTTATTCTGCGAC|CTTCCGAATATTACAATCCTTCCGAATAAC
GAATCTTCGAGCGCACGCCTATGATACTAG|CTTATACAATAGCTTATACAATTACAATCC
CCTTCCGAATAGACTTAGCTTATACAATTA|CTTAGCTTATACAATTACAATCCTTCCGAA
CGAATAACGCGTGACTGCAGGGAACTCTGC|GAGGGAAGAGTGCTAATCGGGGTATATCAC
GCCAGGGACTTCATGCTGTTTTACTCGGGA|GGTGCGGTCTAGCTTATACAATAGCTTATA
CGGTGGTTAGCCGTAAATTGGAGGGAAGAG|TTTTGTTTCGGTATATACCGACTTTAAACA
AATACGGTCCGGGTGGCAGTCGCCCTACGA|ATCCAGAGAAGGCAACATCATCACTTAGCT
AGGGAAGAGTGCTAATCGGGGTATATCACC|CTTTAAACACATCCATGGTTCGGAAGAGCC
CGACCAAAGGCGTCTTTTGGGGGAGGGGAC|TAACGCGTGACTGCAGGGAACTCTGCGGTC
ATGGGTCCGTATATGCTATTCACACTAGGG|GTACAGACAATGGGAGCTGGAAGCTCCGTC
ATCCAGAGAAGGCAACATCATCACTTAGCT|GGTCTCCACTTGGGTGGCAGGTGGGTATGG
CCGGGTGGCAGTCGCCCTACGAATCTTCGA|AAGGCAACATCATCACTTAGCTTATACAAT
GGGTGCGGTCTAGCTTATACAATAGCTTAT|GACTTAGCTTATACAATTACAATCCTTCCG
AGCTTATACAATTACAATCCTTCCGAATAG|TTCCGAATAAAAAGCCAGTAACTAGCACCG
TTATACAATTATAGCTTATACAATTACAAT|TCCGAATATCAACGTGCCCACCTTAGATGA
GGGTGGCAGGTGGGTATGGGCTACCCCAAT|CAAGATTCGAAATTACTACACGACTGCATA
TGATCTGGTCGACAGCTACAACATCGGTGG|GCAAGAATCTCGTAGCTTATACAATTACAA
ATTCTGCGACCAAAGGCGTCTTTTGGGGGA|TCCGAATAACGCGTGACTGCAGGGAACTCT
ACGCCTATGATACTAGTTGGTTTGCCTCAT|TATACAATTACAATCCTTCCGAATATTACA
CTGCAAAATGGCGTAGCTTATACAATTACA|TACAATTACAATCCTTCCGAATAAAAAGCC
CTTATACAATAGCTTATACAATTATAGCTT|CAATTACAATCCTTCCGAATATCAACGTGC
GGGTCCGTATATGCTATTCACACTAGGGAT|ACAGACAATGGGAGCTGGAAGCTCCGTCCG
ATTTCAATCCAGTGGCTTACCCGCCAGGGA|CATGTCTAAAGGTCGGGTTTGGGGTGCGGT
TCTGCCCGATTTTCGCTATCCCATGGGTCC|CTCGCCACCGACGTCGAACCAGGTACAGAC
CACGCCTATGATACTAGTTGGTTTGCCTCA|TTATACAATTACAATCCTTCCGAATATTAC
CTTATACAATTACAATCCTTCCGAATAAAA|ACTCCTAGAAGTGACTGATCTGGTCGACAG
AATCCTTCCGAATAAAATCCTGCGATTGTT|CGAATACAATCCTTCCGAATATTATAGCTT
TTGGGGTGCGGTCTAGCTTATACAATAGCT|ATAGACTTAGCTTATACAATTACAATCCTT
TTCCGAATAAAATCCTGCGATTGTTTTCCG|ACAATCCTTCCGAATATTATAGCTTATACA
TTCTCGCCACCGACGTCGAACCAGGTACAG|GTGGCAGTCGCCCTACGAATCTTCGAGCGC
TACAATCCTTCCGAATATTACAATCCTTCC|ACCCAGCCCCGGTGGTTAGCCGTAAATTGG
CAATTACAATCCTTCCGAATATAACTGGTG|GTAGTTATAGACATCAAGTCTTGGATCGAA
ATACAATTACAATCCTTCCGAATATCCTTC|TTTGGGGGAGGGGACACGGTGCGTTTTATT
GTCTGCCCGATTTTCGCTATCCCATGGGTC|TCTCGCCACCGACGTCGAACCAGGTACAGA
TACAATCCTTCCGAATATAACTGGTGGTAA|TTATAGACATCAAGTCTTGGATCGAAGCCC
CGTTTTATTTGATCCAGAGAAGGCAACATC|GAGGGTGTGATGGTCTCCACTTGGGTGGCA
AATCCTTCCGAATAGACTTAGCTTATACAA|TCGCTTAGCTTATACAATTACAATCCTTCC
ATACAATCCTTCCGAATAGACTTAGCTTAT|TGAGTCGCTTAGCTTATACAATTACAATCC
TAGGGATGAGTCGCTTAGCTTATACAATTA|CCGTCCGTCACAATAGCTTATACAATTACA
ATACAATTACAATCCTTCCGAATAAAATCC|ACAATCCTTCCGAATACAATCCTTCCGAAT
GGTCTCCACTTGGGTGGCAGGTGGGTATGG|GATTCGTTCCACAAGATTCGAAATTACTAC
CGCCTATGATACTAGTTGGTTTGCCTCATG|ATACAATTACAATCCTTCCGAATATTACAA
CGCCCTACGAATCTTCGAGCGCACGCCTAT|TCACTTAGCTTATACAATAGCTTATACAAT
GTGGCAGGTGGGTATGGGCTACCCCAATAG|AGATTCGAAATTACTACACGACTGCATATG
GCTTATACAATTACAATAGCTTATACAATT|TATTCTGCGACCAAAGGCGTCTTTTGGGGG
GCATCTATTCCCCCTCAAGACAATTTCAAT|TGTTTTCCGATATTTCAGAAGGCATGTCTA
TACAATCCTTCCGAATATCAACGTGCCCAC|AATATCGTAGCTTATACAATTACAATCCTT
CGGGTGGCAGTCGCCCTACGAATCTTCGAG|AGGCAACATCATCACTTAGCTTATACAATA
AACTCTGCGGTCAAAAGCGAGGGTGTGATG|TATATCACCCTGCGCGCTATCTTAGATTCG
GCATGTCTAAAGGTCGGGTTTGGGGTGCGG|CCGAATACAATCCTTCCGAATAGACTTAGC
GGTGTGATGGTCTCCACTTGGGTGGCAGGT|TTAGATTCGATTCGTTCCACAAGATTCGAA
ATCCCATGGGTCCGTATATGCTATTCACAC|ACCAGGTACAGACAATGGGAGCTGGAAGCT
CATGCGCCGGGAACCACCCATGCAATCGGA|AGTGGCTTACCCGCCAGGGACTTCATGCTG
TCTGGTCGACAGCTACAACATCGGTGGGTT|AGAATCTCGTAGCTTATACAATTACAATCC
ACAATTACAATCCTTCCGAATATTACAATC|GCGGAACCCAGCCCCGGTGGTTAGCCGTAA
GCTTATACAATTACAATCCTTCCGAATATT|ATAGTAGCGGAACCCAGCCCCGGTGGTTAG
TATACAATTACAATCCTTCCGAATATTACA|GTAGCGGAACCCAGCCCCGGTGGTTAGCCG
GTCGAACCAGGTACAGACAATGGGAGCTGG|ACGAATCTTCGAGCGCACGCCTATGATACT
CCATGCAATCGGACTCCTAGAAGTGACTGA|GGACTTCATGCTGTTTTACTCGGGAAGGCA
GGTACAGACAATGGGAGCTGGAAGCTCCGT|CGAGCGCACGCCTATGATACTAGTTGGTTT
CCAGGGACTTCATGCTGTTTTACTCGGGAA|GTGCGGTCTAGCTTATACAATAGCTTATAC
CAGGGACTTCATGCTGTTTTACTCGGGAAG|TGCGGTCTAGCTTATACAATAGCTTATACA
GCTTATACAATTACAATCCTTCCGAATAAT|CCTTCCGAATATCCTTCCGAATACGGTCCG
TATACAATAGCTTATACAATTATAGCTTAT|ATTACAATCCTTCCGAATATCAACGTGCCC
TATTCACACTAGGGATGAGTCGCTTAGCTT|CTGGAAGCTCCGTCCGTCACAATAGCTTAT
CCTCATGGCTTATTCTGCGACCAAAGGCGT|ATTACAATCCTTCCGAATAACGCGTGACTG
ATCCTTCCGAATACGGTCCGGGTGGCAGTC|TTTTATTTGATCCAGAGAAGGCAACATCAT
TCGGGTTTGGGGTGCGGTCTAGCTTATACA|TTCCGAATAGACTTAGCTTATACAATTACA
TTACTCGGGAAGGCAAGAATCTCGTAGCTT|ATAGCTTATACAATTATAGCTTATACAATT
CAACGTGCCCACCTTAGATGAAAGTCTGCC|ATTACAATCCTTCCGAATAATATTCTCGCC
TTCTTCTCCCCCTAGCTTATACAATTACAA|CACCCATGCAATCGGACTCCTAGAAGTGAC
CTTATACAATTACAATCCTTCCGAATATTA|TAGTAGCGGAACCCAGCCCCGGTGGTTAGC
GCTTATACAATTACAATCCTTCCGAATACA|GTGCCCACCTTAGATGAAAGTCTGCCCGAT
CCACTTGGGTGGCAGGTGGGTATGGGCTAC|GTTCCACAAGATTCGAAATTACTACACGAC
CACCGACGTCGAACCAGGTACAGACAATGG|TCGCCCTACGAATCTTCGAGCGCACGCCTA
TACAATTACAATAGCTTATACAATTACAAT|TGCGACCAAAGGCGTCTTTTGGGGGAGGGG
CCGAATATCAACGTGCCCACCTTAGATGAA|CTTATACAATTACAATCCTTCCGAATAATA
GCGGTCAAAAGCGAGGGTGTGATGGTCTCC|ACCCTGCGCGCTATCTTAGATTCGATTCGT
CAATTACAATCCTTCCGAATAAAAAGCCAG|AGAAGTGACTGATCTGGTCGACAGCTACAA
AAGGTCGGGTTTGGGGTGCGGTCTAGCTTA|ATCCTTCCGAATAGACTTAGCTTATACAAT
TCGGGAAGGCAAGAATCTCGTAGCTTATAC|CTTATACAATTATAGCTTATACAATTACAA
TGCCCGATTTTCGCTATCCCATGGGTCCGT|CGCCACCGACGTCGAACCAGGTACAGACAA
CAAAGGCGTCTTTTGGGGGAGGGGACACGG|GCGTGACTGCAGGGAACTCTGCGGTCAAAA
GTGATGGTCTCCACTTGGGTGGCAGGTGGG|GATTCGATTCGTTCCACAAGATTCGAAATT
ACAATCCTTCCGAATAAAAAGCCAGTAACT|TGACTGATCTGGTCGACAGCTACAACATCG
CCAGTGGCTTACCCGCCAGGGACTTCATGC|AAGGTCGGGTTTGGGGTGCGGTCTAGCTTA
ATAACTGGTGGTAAGCCGTGAGCTGACCCA|TTGGATCGAAGCCCAGTGGAACCCGCGCAT
ACAATCCTTCCGAATATTACAATCCTTCCG|CCCAGCCCCGGTGGTTAGCCGTAAATTGGA
TACAATTATAGCTTATACAATTACAATCCT|GAATATCAACGTGCCCACCTTAGATGAAAG
GTCGGGTTTGGGGTGCGGTCTAGCTTATAC|CTTCCGAATAGACTTAGCTTATACAATTAC
AACCCAGCCCCGGTGGTTAGCCGTAAATTG|ACACCTGACCTTTTGTTTCGGTATATACCG
CTACGAATCTTCGAGCGCACGCCTATGATA|TTAGCTTATACAATAGCTTATACAATTACA
TTATACAATTACAATCCTTCCGAATATCAA|ATCCTTCCGAATATCGTAGCTTATACAATT
CTTATACAATTACAATCCTTCCGAATAAAA|ATTACAATCCTTCCGAATACAATCCTTCCG
GAGGGTGTGATGGTCTCCACTTGGGTGGCA|ATCTTAGATTCGATTCGTTCCACAAGATTC
GCTATCCCATGGGTCCGTATATGCTATTCA|CGAACCAGGTACAGACAATGGGAGCTGGAA
AAATTGGAGGGAAGAGTGCTAATCGGGGTA|ATACCGACTTTAAACACATCCATGGTTCGG
CATGCTGTTTTACTCGGGAAGGCAAGAATC|GCTTATACAATAGCTTATACAATTATAGCT
TCAAAAGCGAGGGTGTGATGGTCTCCACTT|TGCGCGCTATCTTAGATTCGATTCGTTCCA
ATACAATTATAGCTTATACAATTACAATCC|CGAATATCAACGTGCCCACCTTAGATGAAA
TCCTTCCGAATATTATAGCTTATACAATTA|TTCGCTATCCCATGGGTCCGTATATGCTAT
GGGGTGCGGTCTAGCTTATACAATAGCTTA|AGACTTAGCTTATACAATTACAATCCTTCC
TTTATTTGATCCAGAGAAGGCAACATCATC|GGTGTGATGGTCTCCACTTGGGTGGCAGGT
GCAATCGGACTCCTAGAAGTGACTGATCTG|TTCATGCTGTTTTACTCGGGAAGGCAAGAA
TACAATCCTTCCGAATAAAAAGCCAGTAAC|GTGACTGATCTGGTCGACAGCTACAACATC
CCTTCCGAATAGCTTATACAATTACAATCC|TAACTAGCACCGTTTAGTGTAGTTATAGAC
TTATACAATTACAATAGCTTATACAATTAC|TTCTGCGACCAAAGGCGTCTTTTGGGGGAG
TCACACTAGGGATGAGTCGCTTAGCTTATA|GAAGCTCCGTCCGTCACAATAGCTTATACA
CAATGGGAGCTGGAAGCTCCGTCCGTCACA|CGCCTATGATACTAGTTGGTTTGCCTCATG
TCCGTCACAATAGCTTATACAATTACAATA|TGCCTCATGGCTTATTCTGCGACCAAAGGC
TCACTTAGCTTATACAATAGCTTATACAAT|GTGGGTATGGGCTACCCCAATAGTAGCGGA
GCTTATACAATTACAATCCTTCCGAATATC|GTCTTTTGGGGGAGGGGACACGGTGCGTTT
ATATTACAATCCTTCCGAATAACGCGTGAC|GTTAGCCGTAAATTGGAGGGAAGAGTGCTA
TTACAATAGCTTATACAATTACAATCCTTC|CCAAAGGCGTCTTTTGGGGGAGGGGACACG
CTTATACAATTACAATCCTTCCGAATACAA|CGTATATGCTATTCACACTAGGGATGAGTC
CGAGCGCACGCCTATGATACTAGTTGGTTT|AATAGCTTATACAATTACAATCCTTCCGAA
CTGCGACCAAAGGCGTCTTTTGGGGGAGGG|GAATAACGCGTGACTGCAGGGAACTCTGCG
TCCCATGGGTCCGTATATGCTATTCACACT|CCAGGTACAGACAATGGGAGCTGGAAGCTC
GAATATTATAGCTTATACAATTACAATCCT|TCCCATGGGTCCGTATATGCTATTCACACT
GGAACTCTGCGGTCAAAAGCGAGGGTGTGA|GGTATATCACCCTGCGCGCTATCTTAGATT
CAGCTACAACATCGGTGGGTTTGGTCTAGC|TAGCTTATACAATTACAATCCTTCCGAATA
TAGTTGGTTTGCCTCATGGCTTATTCTGCG|TCCTTCCGAATATTACAATCCTTCCGAATA
CGGACTCCTAGAAGTGACTGATCTGGTCGA|GCTGTTTTACTCGGGAAGGCAAGAATCTCG
GGTCCGTATATGCTATTCACACTAGGGATG|CAGACAATGGGAGCTGGAAGCTCCGTCCGT
ACAACATCGGTGGGTTTGGTCTAGCACAGT|TATACAATTACAATCCTTCCGAATAAAATC
CCTGCGATTGTTTTCCGATATTTCAGAAGG|ATATTATAGCTTATACAATTACAATCCTTC
CCTCCTGCAAAATGGCGTAGCTTATACAAT|CTTATACAATTACAATCCTTCCGAATAAAA
ATTGTTTTCCGATATTTCAGAAGGCATGTC|TAGCTTATACAATTACAATCCTTCCGAATA
CGTCGAACCAGGTACAGACAATGGGAGCTG|TACGAATCTTCGAGCGCACGCCTATGATAC
AAGCTCCGTCCGTCACAATAGCTTATACAA|AGTTGGTTTGCCTCATGGCTTATTCTGCGA
CCTTCCGAATATCGTAGCTTATACAATTAC|CTTATACAATTACAATCCTTCCGAATATCC
TATATTGAGCATCTATTCCCCCTCAAGACA|CCTGCGATTGTTTTCCGATATTTCAGAAGG
CAATTACAATCCTTCCGAATAATATTCTCG|AATATCCTTCCGAATACGGTCCGGGTGGCA
TATGGGCTACCCCAATAGTAGCGGAACCCA|ACTACACGACTGCATATGGTTCTTACACCT
GGCAACATCATCACTTAGCTTATACAATAG|TGGGTGGCAGGTGGGTATGGGCTACCCCAA
AATCCTTCCGAATATTATAGCTTATACAAT|TTTTCGCTATCCCATGGGTCCGTATATGCT
CAATCCTTCCGAATATTACAATCCTTCCGA|CCAGCCCCGGTGGTTAGCCGTAAATTGGAG
AGCTTATACAATTACAATCCTTCCGAATAT|CGTCTTTTGGGGGAGGGGACACGGTGCGTT
TTCAATCCAGTGGCTTACCCGCCAGGGACT|TGTCTAAAGGTCGGGTTTGGGGTGCGGTCT
ACATCAAGTCTTGGATCGAAGCCCAGTGGA|ATTGAGCATCTATTCCCCCTCAAGACAATT
TGCCTCATGGCTTATTCTGCGACCAAAGGC|ATATTACAATCCTTCCGAATAACGCGTGAC
GCCAGTAACTAGCACCGTTTAGTGTAGTTA|TACAACATCGGTGGGTTTGGTCTAGCACAG
AATAGTAGCGGAACCCAGCCCCGGTGGTTA|ATATGGTTCTTACACCTGACCTTTTGTTTC
CCGTAAATTGGAGGGAAGAGTGCTAATCGG|GTATATACCGACTTTAAACACATCCATGGT
CGAATATTATAGCTTATACAATTACAATCC|ATCCCATGGGTCCGTATATGCTATTCACAC
CCCGCGCATGCGCCGGGAACCACCCATGCA|CAATCCAGTGGCTTACCCGCCAGGGACTTC
TACTAGTTGGTTTGCCTCATGGCTTATTCT|CAATCCTTCCGAATATTACAATCCTTCCGA
CCAGCCCCGGTGGTTAGCCGTAAATTGGAG|CCTGACCTTTTGTTTCGGTATATACCGACT
TACAATTACAATCCTTCCGAATATCCTTCC|TTGGGGGAGGGGACACGGTGCGTTTTATTT
ATTACAATCCTTCCGAATATTACAATCCTT|GAACCCAGCCCCGGTGGTTAGCCGTAAATT
GTAGTTATAGACATCAAGTCTTGGATCGAA|AGCACAGTATATTGAGCATCTATTCCCCCT
ATCGGTGGGTTTGGTCTAGCACAGTATATT|AATTACAATCCTTCCGAATAAAATCCTGCG
CAATCCTTCCGAATAGCTTATACAATTACA|CCAGTAACTAGCACCGTTTAGTGTAGTTAT
TTACAATCCTTCCGAATATTACAATCCTTC|AACCCAGCCCCGGTGGTTAGCCGTAAATTG
GTTTGGGGTGCGGTCTAGCTTATACAATAG|GAATAGACTTAGCTTATACAATTACAATCC
GGTTTGGTCTAGCACAGTATATTGAGCATC|ATCCTTCCGAATAAAATCCTGCGATTGTTT
CTTATACAATTACAATCCTTCCGAATATCC|TCTTTTGGGGGAGGGGACACGGTGCGTTTT
TGATACTAGTTGGTTTGCCTCATGGCTTAT|TTACAATCCTTCCGAATATTACAATCCTTC
CCGAATATTACAATCCTTCCGAATAACGCG|GGTGGTTAGCCGTAAATTGGAGGGAAGAGT
TGGCTTACCCGCCAGGGACTTCATGCTGTT|TCGGGTTTGGGGTGCGGTCTAGCTTATACA
AGTGGCTTACCCGCCAGGGACTTCATGCTG|GGTCGGGTTTGGGGTGCGGTCTAGCTTATA
AATAGACTTAGCTTATACAATTACAATCCT|TATACAATTACAATCCTTCCGAATATCGTA
AGAAGGCAACATCATCACTTAGCTTATACA|CACTTGGGTGGCAGGTGGGTATGGGCTACC
CTCTAGACATGACCTCCTGCAAAATGGCGT|TTCTCCCCCTAGCTTATACAATTACAATCC
TCCGAATATCCTTCCGAATACGGTCCGGGT|CGGTGCGTTTTATTTGATCCAGAGAAGGCA
TTTGGTCTAGCACAGTATATTGAGCATCTA|CCTTCCGAATAAAATCCTGCGATTGTTTTC
GGGCTACCCCAATAGTAGCGGAACCCAGCC|ACACGACTGCATATGGTTCTTACACCTGAC
GCCCAGTGGAACCCGCGCATGCGCCGGGAA|CAAGACAATTTCAATCCAGTGGCTTACCCG
TATAGCTTATACAATTACAATCCTTCCGAA|CAACGTGCCCACCTTAGATGAAAGTCTGCC
GTGGTAAGCCGTGAGCTGACCCAGCTGGCA|GAAGCCCAGTGGAACCCGCGCATGCGCCGG
CGAATAAAATCCTGCGATTGTTTTCCGATA|ATCCTTCCGAATATTATAGCTTATACAATT
GCTGGCACCCCTTCTTCTCCCCCTAGCTTA|GCGCCGGGAACCACCCATGCAATCGGACTC
TGGCACCCCTTCTTCTCCCCCTAGCTTATA|GCCGGGAACCACCCATGCAATCGGACTCCT
GGAACCACCCATGCAATCGGACTCCTAGAA|CCCGCCAGGGACTTCATGCTGTTTTACTCG
CTATTCCCCCTCAAGACAATTTCAATCCAG|TTCCGATATTTCAGAAGGCATGTCTAAAGG
AGAAGTGACTGATCTGGTCGACAGCTACAA|CTCGGGAAGGCAAGAATCTCGTAGCTTATA
GATGGTCTCCACTTGGGTGGCAGGTGGGTA|TTCGATTCGTTCCACAAGATTCGAAATTAC
GTTATAGACATCAAGTCTTGGATCGAAGCC|ACAGTATATTGAGCATCTATTCCCCCTCAA
TTAGCCGTAAATTGGAGGGAAGAGTGCTAA|TTCGGTATATACCGACTTTAAACACATCCA
CTTCCGAATAATATTCTCGCCACCGACGTC|GAATACGGTCCGGGTGGCAGTCGCCCTACG
ACAATAGCTTATACAATTACAATCCTTCCG|AAAGGCGTCTTTTGGGGGAGGGGACACGGT
TCGAACCAGGTACAGACAATGGGAGCTGGA|CGAATCTTCGAGCGCACGCCTATGATACTA
ACAATTACAATCCTTCCGAATAATATTCTC|GAATATCCTTCCGAATACGGTCCGGGTGGC
ACCACCCATGCAATCGGACTCCTAGAAGTG|GCCAGGGACTTCATGCTGTTTTACTCGGGA
GACTTCATGCTGTTTTACTCGGGAAGGCAA|GTCTAGCTTATACAATAGCTTATACAATTA
CCGGTGGTTAGCCGTAAATTGGAGGGAAGA|CTTTTGTTTCGGTATATACCGACTTTAAAC
CGCGTGACTGCAGGGAACTCTGCGGTCAAA|GAGTGCTAATCGGGGTATATCACCCTGCGC
CGCATGCGCCGGGAACCACCCATGCAATCG|CCAGTGGCTTACCCGCCAGGGACTTCATGC
TACAATTACAATCCTTCCGAATATTACAAT|AGCGGAACCCAGCCCCGGTGGTTAGCCGTA
AGGTCGGGTTTGGGGTGCGGTCTAGCTTAT|TCCTTCCGAATAGACTTAGCTTATACAATT
CTCCCCCTAGCTTATACAATTACAATCCTT|ATGCAATCGGACTCCTAGAAGTGACTGATC
AGTGACTGATCTGGTCGACAGCTACAACAT|GGGAAGGCAAGAATCTCGTAGCTTATACAA
GCTGGAAGCTCCGTCCGTCACAATAGCTTA|ATACTAGTTGGTTTGCCTCATGGCTTATTC
GAAGGCAAGAATCTCGTAGCTTATACAATT|TACAATTATAGCTTATACAATTACAATCCT
ATAGCTTATACAATTACAATCCTTCCGAAT|CCAATAGTAGCGGAACCCAGCCCCGGTGGT
AGGCATGTCTAAAGGTCGGGTTTGGGGTGC|TTCCGAATACAATCCTTCCGAATAGACTTA
ACAATCCTTCCGAATAGCTTATACAATTAC|GCCAGTAACTAGCACCGTTTAGTGTAGTTA
TACGAATCTTCGAGCGCACGCCTATGATAC|TAGCTTATACAATAGCTTATACAATTACAA
AGAATCTCGTAGCTTATACAATTACAATCC|ATAGCTTATACAATTACAATCCTTCCGAAT
AAGACAATTTCAATCCAGTGGCTTACCCGC|AGAAGGCATGTCTAAAGGTCGGGTTTGGGG
ATTGGAGGGAAGAGTGCTAATCGGGGTATA|ACCGACTTTAAACACATCCATGGTTCGGAA
TTGAGCATCTATTCCCCCTCAAGACAATTT|CGATTGTTTTCCGATATTTCAGAAGGCATG
TGATGGTCTCCACTTGGGTGGCAGGTGGGT|ATTCGATTCGTTCCACAAGATTCGAAATTA
TGGTAAGCCGTGAGCTGACCCAGCTGGCAC|AAGCCCAGTGGAACCCGCGCATGCGCCGGG
ATCAAGTCTTGGATCGAAGCCCAGTGGAAC|TGAGCATCTATTCCCCCTCAAGACAATTTC
TATCCCATGGGTCCGTATATGCTATTCACA|AACCAGGTACAGACAATGGGAGCTGGAAGC
AATATCGTAGCTTATACAATTACAATCCTT|AATTACAATCCTTCCGAATATCCTTCCGAA
ATAGACATCAAGTCTTGGATCGAAGCCCAG|GTATATTGAGCATCTATTCCCCCTCAAGAC
AGACTTAGCTTATACAATTACAATCCTTCC|ACAATTACAATCCTTCCGAATATCGTAGCT
GCTACCCCAATAGTAGCGGAACCCAGCCCC|ACGACTGCATATGGTTCTTACACCTGACCT
TCGCTTAGCTTATACAATTACAATCCTTCC|CAATAGCTTATACAATTACAATAGCTTATA
CCGAATATCGTAGCTTATACAATTACAATC|TACAATTACAATCCTTCCGAATATCCTTCC
GGTCAAAAGCGAGGGTGTGATGGTCTCCAC|CCTGCGCGCTATCTTAGATTCGATTCGTTC
GCGCATGCGCCGGGAACCACCCATGCAATC|TCCAGTGGCTTACCCGCCAGGGACTTCATG
AATGGCGTAGCTTATACAATTACAATCCTT|TACAATCCTTCCGAATAAAAAGCCAGTAAC
TGCGGTCTAGCTTATACAATAGCTTATACA|TTAGCTTATACAATTACAATCCTTCCGAAT
GAAGTGACTGATCTGGTCGACAGCTACAAC|TCGGGAAGGCAAGAATCTCGTAGCTTATAC
GAAGGCATGTCTAAAGGTCGGGTTTGGGGT|CCTTCCGAATACAATCCTTCCGAATAGACT
ACTGATCTGGTCGACAGCTACAACATCGGT|AGGCAAGAATCTCGTAGCTTATACAATTAC
TATGATACTAGTTGGTTTGCCTCATGGCTT|AATTACAATCCTTCCGAATATTACAATCCT
AGCATCTATTCCCCCTCAAGACAATTTCAA|TTGTTTTCCGATATTTCAGAAGGCATGTCT
TACAACATCGGTGGGTTTGGTCTAGCACAG|TTATACAATTACAATCCTTCCGAATAAAAT
CATGCAATCGGACTCCTAGAAGTGACTGAT|GACTTCATGCTGTTTTACTCGGGAAGGCAA
AGGGAACTCTGCGGTCAAAAGCGAGGGTGT|GGGGTATATCACCCTGCGCGCTATCTTAGA
TACAATCCTTCCGAATATCGTAGCTTATAC|CAATAGCTTATACAATTACAATCCTTCCGA
TCCTTCCGAATATTACAATCCTTCCGAATA|GCCCCGGTGGTTAGCCGTAAATTGGAGGGA
CCCCGGTGGTTAGCCGTAAATTGGAGGGAA|ACCTTTTGTTTCGGTATATACCGACTTTAA
CCTTCCGAATATCCTTCCGAATACGGTCCG|ACACGGTGCGTTTTATTTGATCCAGAGAAG
TTAGCTTATACAATTACAATCCTTCCGAAT|TTACAATCCTTCCGAATATCGTAGCTTATA
AATTACAATCCTTCCGAATATCGTAGCTTA|TTACAATAGCTTATACAATTACAATCCTTC
TACAATCCTTCCGAATAACGCGTGACTGCA|GCCGTAAATTGGAGGGAAGAGTGCTAATCG
CACCCCTTCTTCTCCCCCTAGCTTATACAA|GGGAACCACCCATGCAATCGGACTCCTAGA
TTACAATCCTTCCGAATAGCTTATACAATT|AAGCCAGTAACTAGCACCGTTTAGTGTAGT
TACAATTACAATCCTTCCGAATAAAAAGCC|CTAGAAGTGACTGATCTGGTCGACAGCTAC
TAGTGTAGTTATAGACATCAAGTCTTGGAT|GTCTAGCACAGTATATTGAGCATCTATTCC
TGGGTCCGTATATGCTATTCACACTAGGGA|TACAGACAATGGGAGCTGGAAGCTCCGTCC
GGGAACTCTGCGGTCAAAAGCGAGGGTGTG|GGGTATATCACCCTGCGCGCTATCTTAGAT
ATCCTTCCGAATAAAAAGCCAGTAACTAGC|CTGATCTGGTCGACAGCTACAACATCGGTG
TACAATCCTTCCGAATAGACTTAGCTTATA|GAGTCGCTTAGCTTATACAATTACAATCCT
CCCTTCTTCTCCCCCTAGCTTATACAATTA|AACCACCCATGCAATCGGACTCCTAGAAGT
CAATCCTTCCGAATATAACTGGTGGTAAGC|ATAGACATCAAGTCTTGGATCGAAGCCCAG
CCCGATTTTCGCTATCCCATGGGTCCGTAT|CCACCGACGTCGAACCAGGTACAGACAATG
GTCTAGCACAGTATATTGAGCATCTATTCC|CCGAATAAAATCCTGCGATTGTTTTCCGAT
ACAATCCTTCCGAATAGACTTAGCTTATAC|AGTCGCTTAGCTTATACAATTACAATCCTT
TAGTTATAGACATCAAGTCTTGGATCGAAG|GCACAGTATATTGAGCATCTATTCCCCCTC
ACTAGTTGGTTTGCCTCATGGCTTATTCTG|AATCCTTCCGAATATTACAATCCTTCCGAA
ATCCAGTGGCTTACCCGCCAGGGACTTCAT|TAAAGGTCGGGTTTGGGGTGCGGTCTAGCT
AAATCCTGCGATTGTTTTCCGATATTTCAG|CCGAATATTATAGCTTATACAATTACAATC
CGAATACGGTCCGGGTGGCAGTCGCCCTAC|TGATCCAGAGAAGGCAACATCATCACTTAG
ACAATTATAGCTTATACAATTACAATCCTT|AATATCAACGTGCCCACCTTAGATGAAAGT
CGACGTCGAACCAGGTACAGACAATGGGAG|CCCTACGAATCTTCGAGCGCACGCCTATGA
TGGTCTAGCACAGTATATTGAGCATCTATT|TTCCGAATAAAATCCTGCGATTGTTTTCCG
CCCTAGCTTATACAATTACAATCCTTCCGA|AATCGGACTCCTAGAAGTGACTGATCTGGT
CAACATCATCACTTAGCTTATACAATAGCT|GGTGGCAGGTGGGTATGGGCTACCCCAATA
ATGCTGTTTTACTCGGGAAGGCAAGAATCT|CTTATACAATAGCTTATACAATTATAGCTT
AATTACAATCCTTCCGAATATCAACGTGCC|CCGAATATCGTAGCTTATACAATTACAATC
CTTAGCTTATACAATTACAATCCTTCCGAA|ATTACAATCCTTCCGAATATCGTAGCTTAT
TCCGAATATAACTGGTGGTAAGCCGTGAGC|TCAAGTCTTGGATCGAAGCCCAGTGGAACC
CTTAGATGAAAGTCTGCCCGATTTTCGCTA|CCGAATAATATTCTCGCCACCGACGTCGAA
CGTAAATTGGAGGGAAGAGTGCTAATCGGG|TATATACCGACTTTAAACACATCCATGGTT
TTCTCCCCCTAGCTTATACAATTACAATCC|CCATGCAATCGGACTCCTAGAAGTGACTGA
GTTTGGTCTAGCACAGTATATTGAGCATCT|TCCTTCCGAATAAAATCCTGCGATTGTTTT
GACATCAAGTCTTGGATCGAAGCCCAGTGG|TATTGAGCATCTATTCCCCCTCAAGACAAT
AGGGATGAGTCGCTTAGCTTATACAATTAC|CGTCCGTCACAATAGCTTATACAATTACAA
CGATATTTCAGAAGGCATGTCTAAAGGTCG|CAATTACAATCCTTCCGAATACAATCCTTC
GGAAGGCAAGAATCTCGTAGCTTATACAAT|ATACAATTATAGCTTATACAATTACAATCC
ATACTAGTTGGTTTGCCTCATGGCTTATTC|ACAATCCTTCCGAATATTACAATCCTTCCG
ACAATTACAATCCTTCCGAATATCGTAGCT|AATTACAATAGCTTATACAATTACAATCCT
TATTACAATCCTTCCGAATAACGCGTGACT|TTAGCCGTAAATTGGAGGGAAGAGTGCTAA
TGGCGTAGCTTATACAATTACAATCCTTCC|CAATCCTTCCGAATAAAAAGCCAGTAACTA
CCTAGAAGTGACTGATCTGGTCGACAGCTA|TTACTCGGGAAGGCAAGAATCTCGTAGCTT
AAGCGAGGGTGTGATGGTCTCCACTTGGGT|CGCTATCTTAGATTCGATTCGTTCCACAAG
AGTCGCCCTACGAATCTTCGAGCGCACGCC|TCATCACTTAGCTTATACAATAGCTTATAC
GGATCGAAGCCCAGTGGAACCCGCGCATGC|TTCCCCCTCAAGACAATTTCAATCCAGTGG
TGACTGATCTGGTCGACAGCTACAACATCG|GAAGGCAAGAATCTCGTAGCTTATACAATT
ATATCAACGTGCCCACCTTAGATGAAAGTC|TACAATTACAATCCTTCCGAATAATATTCT
TCCGAATACAATCCTTCCGAATATTATAGC|TCTGCCCGATTTTCGCTATCCCATGGGTCC
TCCAGTGGCTTACCCGCCAGGGACTTCATG|AAAGGTCGGGTTTGGGGTGCGGTCTAGCTT
TAGCTTATACAATTACAATCCTTCCGAATA|CGGACTCCTAGAAGTGACTGATCTGGTCGA
TGGCAGTCGCCCTACGAATCTTCGAGCGCA|AACATCATCACTTAGCTTATACAATAGCTT
CCCCCTCAAGACAATTTCAATCCAGTGGCT|ATATTTCAGAAGGCATGTCTAAAGGTCGGG
ATACAATAGCTTATACAATTACAATCCTTC|CTACCCCAATAGTAGCGGAACCCAGCCCCG
TAGACATCAAGTCTTGGATCGAAGCCCAGT|TATATTGAGCATCTATTCCCCCTCAAGACA
TCATGCTGTTTTACTCGGGAAGGCAAGAAT|AGCTTATACAATAGCTTATACAATTATAGC
TCCCCCTCAAGACAATTTCAATCCAGTGGC|GATATTTCAGAAGGCATGTCTAAAGGTCGG
CACTAGGGATGAGTCGCTTAGCTTATACAA|GCTCCGTCCGTCACAATAGCTTATACAATT
CTACAACATCGGTGGGTTTGGTCTAGCACA|CTTATACAATTACAATCCTTCCGAATAAAA
CTCTGCGGTCAAAAGCGAGGGTGTGATGGT|TATCACCCTGCGCGCTATCTTAGATTCGAT
AGCTACAACATCGGTGGGTTTGGTCTAGCA|AGCTTATACAATTACAATCCTTCCGAATAA
CACCTTAGATGAAAGTCTGCCCGATTTTCG|CTTCCGAATAATATTCTCGCCACCGACGTC
CACAATAGCTTATACAATTACAATAGCTTA|CATGGCTTATTCTGCGACCAAAGGCGTCTT
CAAAAGCGAGGGTGTGATGGTCTCCACTTG|GCGCGCTATCTTAGATTCGATTCGTTCCAC
CCCATGGGTCCGTATATGCTATTCACACTA|CAGGTACAGACAATGGGAGCTGGAAGCTCC
TCCGAATATTACAATCCTTCCGAATAACGC|CGGTGGTTAGCCGTAAATTGGAGGGAAGAG
GGATGAGTCGCTTAGCTTATACAATTACAA|TCCGTCACAATAGCTTATACAATTACAATA
ACACGGTGCGTTTTATTTGATCCAGAGAAG|TCAAAAGCGAGGGTGTGATGGTCTCCACTT
TCCGAATAGACTTAGCTTATACAATTACAA|AGCTTATACAATTACAATCCTTCCGAATAT
AACTAGCACCGTTTAGTGTAGTTATAGACA|ATCGGTGGGTTTGGTCTAGCACAGTATATT
ACCCATGCAATCGGACTCCTAGAAGTGACT|AGGGACTTCATGCTGTTTTACTCGGGAAGG
CGGGTTTGGGGTGCGGTCTAGCTTATACAA|TCCGAATAGACTTAGCTTATACAATTACAA
CATCAAGTCTTGGATCGAAGCCCAGTGGAA|TTGAGCATCTATTCCCCCTCAAGACAATTT
GGTGGGTATGGGCTACCCCAATAGTAGCGG|GAAATTACTACACGACTGCATATGGTTCTT
ATTACAATCCTTCCGAATAAAAAGCCAGTA|AAGTGACTGATCTGGTCGACAGCTACAACA
AATACAATCCTTCCGAATATTATAGCTTAT|CCCGATTTTCGCTATCCCATGGGTCCGTAT
ATTACAATCCTTCCGAATAACGCGTGACTG|TAGCCGTAAATTGGAGGGAAGAGTGCTAAT
CTTTTGGGGGAGGGGACACGGTGCGTTTTA|CAGGGAACTCTGCGGTCAAAAGCGAGGGTG
GATCTGGTCGACAGCTACAACATCGGTGGG|CAAGAATCTCGTAGCTTATACAATTACAAT
GCAGTCGCCCTACGAATCTTCGAGCGCACG|CATCATCACTTAGCTTATACAATAGCTTAT
TAGCTTATACAATAGCTTATACAATTACAA|TATGGGCTACCCCAATAGTAGCGGAACCCA
ATAGACTTAGCTTATACAATTACAATCCTT|ATACAATTACAATCCTTCCGAATATCGTAG
TATGCTATTCACACTAGGGATGAGTCGCTT|GGGAGCTGGAAGCTCCGTCCGTCACAATAG
TTCCGAATATCGTAGCTTATACAATTACAA|TATACAATTACAATCCTTCCGAATATCCTT
CAATTACAATCCTTCCGAATAAAATCCTGC|ATCCTTCCGAATACAATCCTTCCGAATATT
CTCGTAGCTTATACAATTACAATCCTTCCG|TTATACAATTACAATCCTTCCGAATACAAT
CGAATATCAACGTGCCCACCTTAGATGAAA|TTATACAATTACAATCCTTCCGAATAATAT
ACTCCTAGAAGTGACTGATCTGGTCGACAG|GTTTTACTCGGGAAGGCAAGAATCTCGTAG
CACACTAGGGATGAGTCGCTTAGCTTATAC|AAGCTCCGTCCGTCACAATAGCTTATACAA
ACCCCTTCTTCTCCCCCTAGCTTATACAAT|GGAACCACCCATGCAATCGGACTCCTAGAA
CAATCCAGTGGCTTACCCGCCAGGGACTTC|TCTAAAGGTCGGGTTTGGGGTGCGGTCTAG
GGCAGGTGGGTATGGGCTACCCCAATAGTA|ATTCGAAATTACTACACGACTGCATATGGT
TATACAATTACAATCCTTCCGAATAAAAAG|TCCTAGAAGTGACTGATCTGGTCGACAGCT
CCTTCCGAATAACGCGTGACTGCAGGGAAC|AATTGGAGGGAAGAGTGCTAATCGGGGTAT
ACTCGGGAAGGCAAGAATCTCGTAGCTTAT|AGCTTATACAATTATAGCTTATACAATTAC
TAGCTTATACAATTACAATCCTTCCGAATA|CCGTTTAGTGTAGTTATAGACATCAAGTCT
ATTCACACTAGGGATGAGTCGCTTAGCTTA|TGGAAGCTCCGTCCGTCACAATAGCTTATA
AAGTGACTGATCTGGTCGACAGCTACAACA|CGGGAAGGCAAGAATCTCGTAGCTTATACA
CAGTCGCCCTACGAATCTTCGAGCGCACGC|ATCATCACTTAGCTTATACAATAGCTTATA
CAGTGGAACCCGCGCATGCGCCGGGAACCA|GACAATTTCAATCCAGTGGCTTACCCGCCA
CGTAGCTTATACAATTACAATCCTTCCGAA|TCCTTCCGAATAAAAAGCCAGTAACTAGCA
ATAGCTTATACAATTACAATCCTTCCGAAT|ACCGTTTAGTGTAGTTATAGACATCAAGTC
GTCACAATAGCTTATACAATTACAATAGCT|CTCATGGCTTATTCTGCGACCAAAGGCGTC
TCCGAATAACGCGTGACTGCAGGGAACTCT|TGGAGGGAAGAGTGCTAATCGGGGTATATC
CCCTCAAGACAATTTCAATCCAGTGGCTTA|ATTTCAGAAGGCATGTCTAAAGGTCGGGTT
GGCAGTCGCCCTACGAATCTTCGAGCGCAC|ACATCATCACTTAGCTTATACAATAGCTTA
TCCGAATATCAACGTGCCCACCTTAGATGA|GCTTATACAATTACAATCCTTCCGAATAAT
TAGCTTATACAATTATAGCTTATACAATTA|TCCTTCCGAATATCAACGTGCCCACCTTAG
CTTCCGAATACAATCCTTCCGAATAGACTT|CTAGGGATGAGTCGCTTAGCTTATACAATT
TGGATCGAAGCCCAGTGGAACCCGCGCATG|ATTCCCCCTCAAGACAATTTCAATCCAGTG
TGTAGTTATAGACATCAAGTCTTGGATCGA|TAGCACAGTATATTGAGCATCTATTCCCCC
AAAGTCTGCCCGATTTTCGCTATCCCATGG|TATTCTCGCCACCGACGTCGAACCAGGTAC
GGGTTTGGGGTGCGGTCTAGCTTATACAAT|CCGAATAGACTTAGCTTATACAATTACAAT
TTCCGAATATTACAATCCTTCCGAATAACG|CCGGTGGTTAGCCGTAAATTGGAGGGAAGA
GTCCGGGTGGCAGTCGCCCTACGAATCTTC|AGAAGGCAACATCATCACTTAGCTTATACA
TTACAATCCTTCCGAATATAACTGGTGGTA|GTTATAGACATCAAGTCTTGGATCGAAGCC
GGCTACCCCAATAGTAGCGGAACCCAGCCC|CACGACTGCATATGGTTCTTACACCTGACC
CGCTTAGCTTATACAATTACAATCCTTCCG|AATAGCTTATACAATTACAATAGCTTATAC
GGTCGGGTTTGGGGTGCGGTCTAGCTTATA|CCTTCCGAATAGACTTAGCTTATACAATTA
TTACAATCCTTCCGAATATCCTTCCGAATA|GGAGGGGACACGGTGCGTTTTATTTGATCC
ACCGTTTAGTGTAGTTATAGACATCAAGTC|GGTTTGGTCTAGCACAGTATATTGAGCATC
ATTTCAGAAGGCATGTCTAAAGGTCGGGTT|TACAATCCTTCCGAATACAATCCTTCCGAA
TTACAATCCTTCCGAATACAATCCTTCCGA|TATTCACACTAGGGATGAGTCGCTTAGCTT
GGTCGACAGCTACAACATCGGTGGGTTTGG|ATCTCGTAGCTTATACAATTACAATCCTTC
TCGCCCTACGAATCTTCGAGCGCACGCCTA|ATCACTTAGCTTATACAATAGCTTATACAA
ACATGACCTCCTGCAAAATGGCGTAGCTTA|CCCTAGCTTATACAATTACAATCCTTCCGA
CATCGGTGGGTTTGGTCTAGCACAGTATAT|CAATTACAATCCTTCCGAATAAAATCCTGC
TCCTTCCGAATATCAACGTGCCCACCTTAG|CGTAGCTTATACAATTACAATCCTTCCGAA
TCTAAAGGTCGGGTTTGGGGTGCGGTCTAG|TACAATCCTTCCGAATAGACTTAGCTTATA
TATTCTGCGACCAAAGGCGTCTTTTGGGGG|TTCCGAATAACGCGTGACTGCAGGGAACTC
GTCTAAAGGTCGGGTTTGGGGTGCGGTCTA|ATACAATCCTTCCGAATAGACTTAGCTTAT
ATACAATTACAATCCTTCCGAATATCAACG|CCTTCCGAATATCGTAGCTTATACAATTAC
TTTCGCTATCCCATGGGTCCGTATATGCTA|ACGTCGAACCAGGTACAGACAATGGGAGCT
ATTCTCGCCACCGACGTCGAACCAGGTACA|GGTGGCAGTCGCCCTACGAATCTTCGAGCG
CCAGCTGGCACCCCTTCTTCTCCCCCTAGC|CATGCGCCGGGAACCACCCATGCAATCGGA
AACGCGTGACTGCAGGGAACTCTGCGGTCA|AAGAGTGCTAATCGGGGTATATCACCCTGC
GGTCTAGCTTATACAATAGCTTATACAATT|GCTTATACAATTACAATCCTTCCGAATATC
CCGATATTTCAGAAGGCATGTCTAAAGGTC|ACAATTACAATCCTTCCGAATACAATCCTT
CGCGCATGCGCCGGGAACCACCCATGCAAT|ATCCAGTGGCTTACCCGCCAGGGACTTCAT
CATGGCTTATTCTGCGACCAAAGGCGTCTT|ACAATCCTTCCGAATAACGCGTGACTGCAG
ATACAATTACAATCCTTCCGAATAATATTC|CCGAATATCCTTCCGAATACGGTCCGGGTG
CGCCACCGACGTCGAACCAGGTACAGACAA|CAGTCGCCCTACGAATCTTCGAGCGCACGC
AATACAATCCTTCCGAATAGACTTAGCTTA|ATGAGTCGCTTAGCTTATACAATTACAATC
CGAAGCCCAGTGGAACCCGCGCATGCGCCG|CCCTCAAGACAATTTCAATCCAGTGGCTTA
ATTACAATCCTTCCGAATATAACTGGTGGT|AGTTATAGACATCAAGTCTTGGATCGAAGC
CCTTCCGAATATTACAATCCTTCCGAATAA|CCCCGGTGGTTAGCCGTAAATTGGAGGGAA
GCCCGATTTTCGCTATCCCATGGGTCCGTA|GCCACCGACGTCGAACCAGGTACAGACAAT
TAAAAAGCCAGTAACTAGCACCGTTTAGTG|GACAGCTACAACATCGGTGGGTTTGGTCTA
CCTATGATACTAGTTGGTTTGCCTCATGGC|ACAATTACAATCCTTCCGAATATTACAATC
CCCGGTGGTTAGCCGTAAATTGGAGGGAAG|CCTTTTGTTTCGGTATATACCGACTTTAAA
TTTTATTTGATCCAGAGAAGGCAACATCAT|GGGTGTGATGGTCTCCACTTGGGTGGCAGG
GGCATGTCTAAAGGTCGGGTTTGGGGTGCG|TCCGAATACAATCCTTCCGAATAGACTTAG
GACCAAAGGCGTCTTTTGGGGGAGGGGACA|AACGCGTGACTGCAGGGAACTCTGCGGTCA
TTAGATGAAAGTCTGCCCGATTTTCGCTAT|CGAATAATATTCTCGCCACCGACGTCGAAC
GCAACATCATCACTTAGCTTATACAATAGC|GGGTGGCAGGTGGGTATGGGCTACCCCAAT
GGGACACGGTGCGTTTTATTTGATCCAGAG|CGGTCAAAAGCGAGGGTGTGATGGTCTCCA
AGTTATAGACATCAAGTCTTGGATCGAAGC|CACAGTATATTGAGCATCTATTCCCCCTCA
ACTAGGGATGAGTCGCTTAGCTTATACAAT|CTCCGTCCGTCACAATAGCTTATACAATTA
TCGGTGGGTTTGGTCTAGCACAGTATATTG|ATTACAATCCTTCCGAATAAAATCCTGCGA
TATACAATTACAATCCTTCCGAATACAATC|CCCACCTTAGATGAAAGTCTGCCCGATTTT
ACAATAGCTTATACAATTATAGCTTATACA|ACAATCCTTCCGAATATCAACGTGCCCACC
CAGGTACAGACAATGGGAGCTGGAAGCTCC|TTCGAGCGCACGCCTATGATACTAGTTGGT
TCTTTTGGGGGAGGGGACACGGTGCGTTTT|GCAGGGAACTCTGCGGTCAAAAGCGAGGGT
ATACAATAGCTTATACAATTATAGCTTATA|TTACAATCCTTCCGAATATCAACGTGCCCA
TTATACAATAGCTTATACAATTACAATCCT|GGCTACCCCAATAGTAGCGGAACCCAGCCC
TTCCGAATATCCTTCCGAATACGGTCCGGG|ACGGTGCGTTTTATTTGATCCAGAGAAGGC
TAGCTTATACAATTACAATCCTTCCGAATA|ACGTGCCCACCTTAGATGAAAGTCTGCCCG
GATACTAGTTGGTTTGCCTCATGGCTTATT|TACAATCCTTCCGAATATTACAATCCTTCC
AACCACCCATGCAATCGGACTCCTAGAAGT|CGCCAGGGACTTCATGCTGTTTTACTCGGG
AGTTGGTTTGCCTCATGGCTTATTCTGCGA|CCTTCCGAATATTACAATCCTTCCGAATAA
ACTTAGCTTATACAATAGCTTATACAATTA|GGGTATGGGCTACCCCAATAGTAGCGGAAC
CCTTAGATGAAAGTCTGCCCGATTTTCGCT|TCCGAATAATATTCTCGCCACCGACGTCGA
ATAAAATCCTGCGATTGTTTTCCGATATTT|CTTCCGAATATTATAGCTTATACAATTACA
TGGGTGGCAGGTGGGTATGGGCTACCCCAA|ACAAGATTCGAAATTACTACACGACTGCAT
ATTACAATCCTTCCGAATATCAACGTGCCC|CGAATATCGTAGCTTATACAATTACAATCC
TAGCTTATACAATTACAATCCTTCCGAATA|CTTCCGAATAAAAAGCCAGTAACTAGCACC
AATAGCTTATACAATTACAATCCTTCCGAA|CCCAATAGTAGCGGAACCCAGCCCCGGTGG
CAGTGGCTTACCCGCCAGGGACTTCATGCT|AGGTCGGGTTTGGGGTGCGGTCTAGCTTAT
GAACTCTGCGGTCAAAAGCGAGGGTGTGAT|GTATATCACCCTGCGCGCTATCTTAGATTC
TCGCTATCCCATGGGTCCGTATATGCTATT|GTCGAACCAGGTACAGACAATGGGAGCTGG
GGGAACCACCCATGCAATCGGACTCCTAGA|ACCCGCCAGGGACTTCATGCTGTTTTACTC
AGGTGGGTATGGGCTACCCCAATAGTAGCG|CGAAATTACTACACGACTGCATATGGTTCT
GGGTGTGATGGTCTCCACTTGGGTGGCAGG|CTTAGATTCGATTCGTTCCACAAGATTCGA
AAGCCGTGAGCTGACCCAGCTGGCACCCCT|CCAGTGGAACCCGCGCATGCGCCGGGAACC
ATCCTTCCGAATAACGCGTGACTGCAGGGA|TAAATTGGAGGGAAGAGTGCTAATCGGGGT
TTATACAATTACAATCCTTCCGAATAAAAA|CTCCTAGAAGTGACTGATCTGGTCGACAGC
TCTTCTCCCCCTAGCTTATACAATTACAAT|ACCCATGCAATCGGACTCCTAGAAGTGACT
CTAGTTGGTTTGCCTCATGGCTTATTCTGC|ATCCTTCCGAATATTACAATCCTTCCGAAT
GCTTATACAATTACAATCCTTCCGAATAGC|TCCGAATAAAAAGCCAGTAACTAGCACCGT
ATCGAAGCCCAGTGGAACCCGCGCATGCGC|CCCCCTCAAGACAATTTCAATCCAGTGGCT
TTATAGCTTATACAATTACAATCCTTCCGA|TGGGTCCGTATATGCTATTCACACTAGGGA
GCTTATACAATTATAGCTTATACAATTACA|CTTCCGAATATCAACGTGCCCACCTTAGAT
ATTCCCCCTCAAGACAATTTCAATCCAGTG|CCGATATTTCAGAAGGCATGTCTAAAGGTC
CTTACCCGCCAGGGACTTCATGCTGTTTTA|GGTTTGGGGTGCGGTCTAGCTTATACAATA
TCTCGCCACCGACGTCGAACCAGGTACAGA|TGGCAGTCGCCCTACGAATCTTCGAGCGCA
TATACAATTACAATCCTTCCGAATAGCTTA|GAATAAAAAGCCAGTAACTAGCACCGTTTA
ACCCCAATAGTAGCGGAACCCAGCCCCGGT|ACTGCATATGGTTCTTACACCTGACCTTTT
TCCACTTGGGTGGCAGGTGGGTATGGGCTA|CGTTCCACAAGATTCGAAATTACTACACGA
AATCCTTCCGAATATCCTTCCGAATACGGT|GGGACACGGTGCGTTTTATTTGATCCAGAG
TTCGAGCGCACGCCTATGATACTAGTTGGT|ACAATAGCTTATACAATTACAATCCTTCCG
GAATAAAAAGCCAGTAACTAGCACCGTTTA|GTCGACAGCTACAACATCGGTGGGTTTGGT
CTGCAGGGAACTCTGCGGTCAAAAGCGAGG|AATCGGGGTATATCACCCTGCGCGCTATCT
AAGGCATGTCTAAAGGTCGGGTTTGGGGTG|CTTCCGAATACAATCCTTCCGAATAGACTT
TATACAATTACAATCCTTCCGAATAAAATC|TACAATCCTTCCGAATACAATCCTTCCGAA
AATCCAGTGGCTTACCCGCCAGGGACTTCA|CTAAAGGTCGGGTTTGGGGTGCGGTCTAGC
CAAGTCTTGGATCGAAGCCCAGTGGAACCC|AGCATCTATTCCCCCTCAAGACAATTTCAA
TATTATAGCTTATACAATTACAATCCTTCC|CATGGGTCCGTATATGCTATTCACACTAGG
TACAATAGCTTATACAATTACAATCCTTCC|TACCCCAATAGTAGCGGAACCCAGCCCCGG
GACTCCTAGAAGTGACTGATCTGGTCGACA|TGTTTTACTCGGGAAGGCAAGAATCTCGTA
GACAATGGGAGCTGGAAGCTCCGTCCGTCA|CACGCCTATGATACTAGTTGGTTTGCCTCA
AAAGCCAGTAACTAGCACCGTTTAGTGTAG|AGCTACAACATCGGTGGGTTTGGTCTAGCA
TCCGTCCGTCACAATAGCTTATACAATTAC|GGTTTGCCTCATGGCTTATTCTGCGACCAA
GGGGGAGGGGACACGGTGCGTTTTATTTGA|AACTCTGCGGTCAAAAGCGAGGGTGTGATG
TCCGAATACGGTCCGGGTGGCAGTCGCCCT|TTTGATCCAGAGAAGGCAACATCATCACTT
TTTTCGCTATCCCATGGGTCCGTATATGCT|GACGTCGAACCAGGTACAGACAATGGGAGC
GCCGTGAGCTGACCCAGCTGGCACCCCTTC|AGTGGAACCCGCGCATGCGCCGGGAACCAC
ACAATTACAATCCTTCCGAATAGCTTATAC|TAAAAAGCCAGTAACTAGCACCGTTTAGTG
TTCCCCCTCAAGACAATTTCAATCCAGTGG|CGATATTTCAGAAGGCATGTCTAAAGGTCG
TAGACATGACCTCCTGCAAAATGGCGTAGC|TCCCCCTAGCTTATACAATTACAATCCTTC
CCTTCCGAATAAAATCCTGCGATTGTTTTC|ATACAATCCTTCCGAATATTATAGCTTATA
GTGCGGTCTAGCTTATACAATAGCTTATAC|CTTAGCTTATACAATTACAATCCTTCCGAA
CTTCCGAATATCCTTCCGAATACGGTCCGG|CACGGTGCGTTTTATTTGATCCAGAGAAGG
AGCTGACCCAGCTGGCACCCCTTCTTCTCC|ACCCGCGCATGCGCCGGGAACCACCCATGC
TCCGAATAAAATCCTGCGATTGTTTTCCGA|CAATCCTTCCGAATATTATAGCTTATACAA
AGCGAGGGTGTGATGGTCTCCACTTGGGTG|GCTATCTTAGATTCGATTCGTTCCACAAGA
ACAATAGCTTATACAATTACAATCCTTCCG|ACCCCAATAGTAGCGGAACCCAGCCCCGGT
GAGCGCACGCCTATGATACTAGTTGGTTTG|ATAGCTTATACAATTACAATCCTTCCGAAT
TTCGCTATCCCATGGGTCCGTATATGCTAT|CGTCGAACCAGGTACAGACAATGGGAGCTG
GGTGGCAGGTGGGTATGGGCTACCCCAATA|AAGATTCGAAATTACTACACGACTGCATAT
CCTTCCGAATACAATCCTTCCGAATAGACT|ACTAGGGATGAGTCGCTTAGCTTATACAAT
GCTTATACAATTACAATCCTTCCGAATAAA|GACTCCTAGAAGTGACTGATCTGGTCGACA
CTATGATACTAGTTGGTTTGCCTCATGGCT|CAATTACAATCCTTCCGAATATTACAATCC
AGGGGACACGGTGCGTTTTATTTGATCCAG|TGCGGTCAAAAGCGAGGGTGTGATGGTCTC
CAATAGCTTATACAATTACAATCCTTCCGA|CCCCAATAGTAGCGGAACCCAGCCCCGGTG
GGACTTCATGCTGTTTTACTCGGGAAGGCA|GGTCTAGCTTATACAATAGCTTATACAATT
AGAAGGCATGTCTAAAGGTCGGGTTTGGGG|TCCTTCCGAATACAATCCTTCCGAATAGAC
ATCCTTCCGAATAGCTTATACAATTACAAT|AGTAACTAGCACCGTTTAGTGTAGTTATAG
ACAATTACAATCCTTCCGAATACAATCCTT|ATGCTATTCACACTAGGGATGAGTCGCTTA
TATACAATTACAATCCTTCCGAATATCGTA|TACAATTACAATAGCTTATACAATTACAAT
AGCTTATACAATTACAATCCTTCCGAATAT|AATAGTAGCGGAACCCAGCCCCGGTGGTTA
ACAATTACAATCCTTCCGAATAAAAAGCCA|TAGAAGTGACTGATCTGGTCGACAGCTACA
AGCCAGTAACTAGCACCGTTTAGTGTAGTT|CTACAACATCGGTGGGTTTGGTCTAGCACA
ACAATCCTTCCGAATATCGTAGCTTATACA|AATAGCTTATACAATTACAATCCTTCCGAA
CGGAACCCAGCCCCGGTGGTTAGCCGTAAA|CTTACACCTGACCTTTTGTTTCGGTATATA
GTCTTGGATCGAAGCCCAGTGGAACCCGCG|ATCTATTCCCCCTCAAGACAATTTCAATCC
CCGAATAATATTCTCGCCACCGACGTCGAA|TACGGTCCGGGTGGCAGTCGCCCTACGAAT
ATCCTTCCGAATATTATAGCTTATACAATT|TTTCGCTATCCCATGGGTCCGTATATGCTA
ACCTCCTGCAAAATGGCGTAGCTTATACAA|GCTTATACAATTACAATCCTTCCGAATAAA
CGAATATCGTAGCTTATACAATTACAATCC|ACAATTACAATCCTTCCGAATATCCTTCCG
TTGGTTTGCCTCATGGCTTATTCTGCGACC|TTCCGAATATTACAATCCTTCCGAATAACG
TAGCTTATACAATTACAATCCTTCCGAATA|GTCCGTATATGCTATTCACACTAGGGATGA
AGGCGTCTTTTGGGGGAGGGGACACGGTGC|TGACTGCAGGGAACTCTGCGGTCAAAAGCG
GAGGGAAGAGTGCTAATCGGGGTATATCAC|ACTTTAAACACATCCATGGTTCGGAAGAGC
ACGGTCCGGGTGGCAGTCGCCCTACGAATC|CAGAGAAGGCAACATCATCACTTAGCTTAT
AATCCTTCCGAATATCGTAGCTTATACAAT|TAGCTTATACAATTACAATCCTTCCGAATA
GTAGCGGAACCCAGCCCCGGTGGTTAGCCG|GGTTCTTACACCTGACCTTTTGTTTCGGTA
GCTTAGCTTATACAATTACAATCCTTCCGA|ATAGCTTATACAATTACAATAGCTTATACA
ACAATCCTTCCGAATATCAACGTGCCCACC|ATATCGTAGCTTATACAATTACAATCCTTC
TTCAGAAGGCATGTCTAAAGGTCGGGTTTG|CAATCCTTCCGAATACAATCCTTCCGAATA
TACAATAGCTTATACAATTACAATCCTTCC|CAAAGGCGTCTTTTGGGGGAGGGGACACGG
CCGAATAGCTTATACAATTACAATCCTTCC|TAGCACCGTTTAGTGTAGTTATAGACATCA
AATATAACTGGTGGTAAGCCGTGAGCTGAC|GTCTTGGATCGAAGCCCAGTGGAACCCGCG
ACAGTATATTGAGCATCTATTCCCCCTCAA|AAATCCTGCGATTGTTTTCCGATATTTCAG
ATCCTTCCGAATACAATCCTTCCGAATATT|GAAAGTCTGCCCGATTTTCGCTATCCCATG
CTTCCGAATAACGCGTGACTGCAGGGAACT|ATTGGAGGGAAGAGTGCTAATCGGGGTATA
ATTACAATCCTTCCGAATAGCTTATACAAT|AAAGCCAGTAACTAGCACCGTTTAGTGTAG
CTTATACAATTACAATCCTTCCGAATATCA|AATCCTTCCGAATATCGTAGCTTATACAAT
GGTCTAGCACAGTATATTGAGCATCTATTC|TCCGAATAAAATCCTGCGATTGTTTTCCGA
AATCCTTCCGAATAATATTCTCGCCACCGA|TTCCGAATACGGTCCGGGTGGCAGTCGCCC
TAGTAGCGGAACCCAGCCCCGGTGGTTAGC|ATGGTTCTTACACCTGACCTTTTGTTTCGG
CTTAGCTTATACAATTACAATCCTTCCGAA|TAGCTTATACAATTACAATAGCTTATACAA
CTCAAGACAATTTCAATCCAGTGGCTTACC|TTCAGAAGGCATGTCTAAAGGTCGGGTTTG
AGCTTATACAATTACAATCCTTCCGAATAT|CGTTTAGTGTAGTTATAGACATCAAGTCTT
ACGGTGCGTTTTATTTGATCCAGAGAAGGC|AAAAGCGAGGGTGTGATGGTCTCCACTTGG
TTTGGGGTGCGGTCTAGCTTATACAATAGC|AATAGACTTAGCTTATACAATTACAATCCT
TACCCGCCAGGGACTTCATGCTGTTTTACT|TTTGGGGTGCGGTCTAGCTTATACAATAGC
CAATCGGACTCCTAGAAGTGACTGATCTGG|TCATGCTGTTTTACTCGGGAAGGCAAGAAT
ATTATAGCTTATACAATTACAATCCTTCCG|ATCAACGTGCCCACCTTAGATGAAAGTCTG
TATACAATTACAATCCTTCCGAATATCCTT|TTTTGGGGGAGGGGACACGGTGCGTTTTAT
TTCCGAATATAACTGGTGGTAAGCCGTGAG|ATCAAGTCTTGGATCGAAGCCCAGTGGAAC
TATACAATTACAATAGCTTATACAATTACA|TCTGCGACCAAAGGCGTCTTTTGGGGGAGG
GCTATTCACACTAGGGATGAGTCGCTTAGC|AGCTGGAAGCTCCGTCCGTCACAATAGCTT
GACTGCAGGGAACTCTGCGGTCAAAAGCGA|CTAATCGGGGTATATCACCCTGCGCGCTAT
TAGAAGTGACTGATCTGGTCGACAGCTACA|ACTCGGGAAGGCAAGAATCTCGTAGCTTAT
CAGGGAACTCTGCGGTCAAAAGCGAGGGTG|CGGGGTATATCACCCTGCGCGCTATCTTAG
TGGTTTGCCTCATGGCTTATTCTGCGACCA|TCCGAATATTACAATCCTTCCGAATAACGC
CCTGCAAAATGGCGTAGCTTATACAATTAC|ATACAATTACAATCCTTCCGAATAAAAAGC
TTTGATCCAGAGAAGGCAACATCATCACTT|TGATGGTCTCCACTTGGGTGGCAGGTGGGT
TACAATAGCTTATACAATTATAGCTTATAC|TACAATCCTTCCGAATATCAACGTGCCCAC
CACTTAGCTTATACAATAGCTTATACAATT|TGGGTATGGGCTACCCCAATAGTAGCGGAA
AAGCCCAGTGGAACCCGCGCATGCGCCGGG|CTCAAGACAATTTCAATCCAGTGGCTTACC
CCAGAGAAGGCAACATCATCACTTAGCTTA|TCTCCACTTGGGTGGCAGGTGGGTATGGGC
TGGGCTACCCCAATAGTAGCGGAACCCAGC|TACACGACTGCATATGGTTCTTACACCTGA
ACAATCCTTCCGAATAACGCGTGACTGCAG|CCGTAAATTGGAGGGAAGAGTGCTAATCGG
CGAATATCCTTCCGAATACGGTCCGGGTGG|GTGCGTTTTATTTGATCCAGAGAAGGCAAC
GCTTATACAATTACAATCCTTCCGAATATC|TTATACAATTACAATAGCTTATACAATTAC
CTGGAAGCTCCGTCCGTCACAATAGCTTAT|TACTAGTTGGTTTGCCTCATGGCTTATTCT
CAATTACAATCCTTCCGAATAGCTTATACA|AAAAAGCCAGTAACTAGCACCGTTTAGTGT
TCCGAATATCGTAGCTTATACAATTACAAT|ATACAATTACAATCCTTCCGAATATCCTTC
CATGTCTAAAGGTCGGGTTTGGGGTGCGGT|CGAATACAATCCTTCCGAATAGACTTAGCT
CCGAATAACGCGTGACTGCAGGGAACTCTG|GGAGGGAAGAGTGCTAATCGGGGTATATCA
CCTTCCGAATATAACTGGTGGTAAGCCGTG|ACATCAAGTCTTGGATCGAAGCCCAGTGGA
GGGTGGCAGTCGCCCTACGAATCTTCGAGC|GGCAACATCATCACTTAGCTTATACAATAG
CCGAATACAATCCTTCCGAATAGACTTAGC|GGGATGAGTCGCTTAGCTTATACAATTACA
AATCCTTCCGAATACAATCCTTCCGAATAT|TGAAAGTCTGCCCGATTTTCGCTATCCCAT
TCCGAATAAAAAGCCAGTAACTAGCACCGT|CTGGTCGACAGCTACAACATCGGTGGGTTT
GGCTTACCCGCCAGGGACTTCATGCTGTTT|CGGGTTTGGGGTGCGGTCTAGCTTATACAA
AAGGCAACATCATCACTTAGCTTATACAAT|CTTGGGTGGCAGGTGGGTATGGGCTACCCC
GGTGGTTAGCCGTAAATTGGAGGGAAGAGT|TTTGTTTCGGTATATACCGACTTTAAACAC
GCCGGGAACCACCCATGCAATCGGACTCCT|CTTACCCGCCAGGGACTTCATGCTGTTTTA
TAAGCCGTGAGCTGACCCAGCTGGCACCCC|CCCAGTGGAACCCGCGCATGCGCCGGGAAC
TTATACAATTACAATCCTTCCGAATAATAT|TTCCGAATATCCTTCCGAATACGGTCCGGG
ATATGCTATTCACACTAGGGATGAGTCGCT|TGGGAGCTGGAAGCTCCGTCCGTCACAATA
AATATTATAGCTTATACAATTACAATCCTT|CCCATGGGTCCGTATATGCTATTCACACTA
TATTCCCCCTCAAGACAATTTCAATCCAGT|TCCGATATTTCAGAAGGCATGTCTAAAGGT
AAGTCTTGGATCGAAGCCCAGTGGAACCCG|GCATCTATTCCCCCTCAAGACAATTTCAAT
ATCCTTCCGAATATCGTAGCTTATACAATT|AGCTTATACAATTACAATCCTTCCGAATAT
CTTCCGAATACAATCCTTCCGAATATTATA|AGTCTGCCCGATTTTCGCTATCCCATGGGT
CTTCCGAATATAACTGGTGGTAAGCCGTGA|CATCAAGTCTTGGATCGAAGCCCAGTGGAA
CGAATATAACTGGTGGTAAGCCGTGAGCTG|AAGTCTTGGATCGAAGCCCAGTGGAACCCG
GGTTAGCCGTAAATTGGAGGGAAGAGTGCT|GTTTCGGTATATACCGACTTTAAACACATC
TACAATTACAATCCTTCCGAATATCAACGT|CTTCCGAATATCGTAGCTTATACAATTACA
GGCACCCCTTCTTCTCCCCCTAGCTTATAC|CCGGGAACCACCCATGCAATCGGACTCCTA
TTACAATCCTTCCGAATATCGTAGCTTATA|ACAATAGCTTATACAATTACAATCCTTCCG
AGCTTATACAATTACAATCCTTCCGAATAT|ACAATCCTTCCGAATATCGTAGCTTATACA
CAATCCTTCCGAATAACGCGTGACTGCAGG|CGTAAATTGGAGGGAAGAGTGCTAATCGGG
TTACAATCCTTCCGAATAATATTCTCGCCA|ATCCTTCCGAATACGGTCCGGGTGGCAGTC
ACCCGCCAGGGACTTCATGCTGTTTTACTC|TTGGGGTGCGGTCTAGCTTATACAATAGCT
TTCATGCTGTTTTACTCGGGAAGGCAAGAA|TAGCTTATACAATAGCTTATACAATTATAG
TCCTAGAAGTGACTGATCTGGTCGACAGCT|TTTACTCGGGAAGGCAAGAATCTCGTAGCT
ACAATTACAATCCTTCCGAATATCCTTCCG|TGGGGGAGGGGACACGGTGCGTTTTATTTG
CTTCCGAATATCAACGTGCCCACCTTAGAT|TAGCTTATACAATTACAATCCTTCCGAATA
GTTAGCCGTAAATTGGAGGGAAGAGTGCTA|TTTCGGTATATACCGACTTTAAACACATCC
GTGGCTTACCCGCCAGGGACTTCATGCTGT|GTCGGGTTTGGGGTGCGGTCTAGCTTATAC
AAAGCGAGGGTGTGATGGTCTCCACTTGGG|GCGCTATCTTAGATTCGATTCGTTCCACAA
CGCACGCCTATGATACTAGTTGGTTTGCCT|GCTTATACAATTACAATCCTTCCGAATATT
TTATACAATTACAATCCTTCCGAATAGCTT|CGAATAAAAAGCCAGTAACTAGCACCGTTT
TCAACGTGCCCACCTTAGATGAAAGTCTGC|AATTACAATCCTTCCGAATAATATTCTCGC
GCTTATACAATTACAATCCTTCCGAATAAA|AATTACAATCCTTCCGAATACAATCCTTCC
AAAGGCGTCTTTTGGGGGAGGGGACACGGT|CGTGACTGCAGGGAACTCTGCGGTCAAAAG
CCTCAAGACAATTTCAATCCAGTGGCTTAC|TTTCAGAAGGCATGTCTAAAGGTCGGGTTT
TACAATCCTTCCGAATAATATTCTCGCCAC|TCCTTCCGAATACGGTCCGGGTGGCAGTCG
TCCGATATTTCAGAAGGCATGTCTAAAGGT|TACAATTACAATCCTTCCGAATACAATCCT
CATGACCTCCTGCAAAATGGCGTAGCTTAT|CCTAGCTTATACAATTACAATCCTTCCGAA
AGACAATGGGAGCTGGAAGCTCCGTCCGTC|GCACGCCTATGATACTAGTTGGTTTGCCTC
CACCGTTTAGTGTAGTTATAGACATCAAGT|GGGTTTGGTCTAGCACAGTATATTGAGCAT
GCCGTAAATTGGAGGGAAGAGTGCTAATCG|GGTATATACCGACTTTAAACACATCCATGG
GGTGCGGTCTAGCTTATACAATAGCTTATA|ACTTAGCTTATACAATTACAATCCTTCCGA
CATCTATTCCCCCTCAAGACAATTTCAATC|GTTTTCCGATATTTCAGAAGGCATGTCTAA
AAGAATCTCGTAGCTTATACAATTACAATC|TATAGCTTATACAATTACAATCCTTCCGAA
TTCACACTAGGGATGAGTCGCTTAGCTTAT|GGAAGCTCCGTCCGTCACAATAGCTTATAC
AAGCCAGTAACTAGCACCGTTTAGTGTAGT|GCTACAACATCGGTGGGTTTGGTCTAGCAC
CGAATCTTCGAGCGCACGCCTATGATACTA|GCTTATACAATAGCTTATACAATTACAATC
AATTACAATCCTTCCGAATACAATCCTTCC|GCTATTCACACTAGGGATGAGTCGCTTAGC
CTTCCGAATAGACTTAGCTTATACAATTAC|TTAGCTTATACAATTACAATCCTTCCGAAT
ATACGGTCCGGGTGGCAGTCGCCCTACGAA|TCCAGAGAAGGCAACATCATCACTTAGCTT
AATCTTCGAGCGCACGCCTATGATACTAGT|TTATACAATAGCTTATACAATTACAATCCT
AATCCTTCCGAATAACGCGTGACTGCAGGG|GTAAATTGGAGGGAAGAGTGCTAATCGGGG
TCTTGGATCGAAGCCCAGTGGAACCCGCGC|TCTATTCCCCCTCAAGACAATTTCAATCCA
TTATACAATTACAATCCTTCCGAATACAAT|GTATATGCTATTCACACTAGGGATGAGTCG
TCCTTCCGAATACAATCCTTCCGAATAGAC|CACTAGGGATGAGTCGCTTAGCTTATACAA
TCGTAGCTTATACAATTACAATCCTTCCGA|ACAATCCTTCCGAATATCCTTCCGAATACG
GCATGCGCCGGGAACCACCCATGCAATCGG|CAGTGGCTTACCCGCCAGGGACTTCATGCT
CCGAATAGACTTAGCTTATACAATTACAAT|GCTTATACAATTACAATCCTTCCGAATATC
GTGGAACCCGCGCATGCGCCGGGAACCACC|CAATTTCAATCCAGTGGCTTACCCGCCAGG
TGCGATTGTTTTCCGATATTTCAGAAGGCA|ATTATAGCTTATACAATTACAATCCTTCCG
AATTACAATCCTTCCGAATACAATCCTTCC|CTTAGATGAAAGTCTGCCCGATTTTCGCTA
CTTCCGAATATCGTAGCTTATACAATTACA|TTATACAATTACAATCCTTCCGAATATCCT
GAATAGCTTATACAATTACAATCCTTCCGA|GCACCGTTTAGTGTAGTTATAGACATCAAG
TATACAATTACAATCCTTCCGAATATCAAC|TCCTTCCGAATATCGTAGCTTATACAATTA
CTATCCCATGGGTCCGTATATGCTATTCAC|GAACCAGGTACAGACAATGGGAGCTGGAAG
GCGGAACCCAGCCCCGGTGGTTAGCCGTAA|TCTTACACCTGACCTTTTGTTTCGGTATAT
TCGAGCGCACGCCTATGATACTAGTTGGTT|CAATAGCTTATACAATTACAATCCTTCCGA
TGGGTTTGGTCTAGCACAGTATATTGAGCA|CAATCCTTCCGAATAAAATCCTGCGATTGT
TTGGGTGGCAGGTGGGTATGGGCTACCCCA|CACAAGATTCGAAATTACTACACGACTGCA
GCTTATTCTGCGACCAAAGGCGTCTTTTGG|TCCTTCCGAATAACGCGTGACTGCAGGGAA
ACCCAGCCCCGGTGGTTAGCCGTAAATTGG|CACCTGACCTTTTGTTTCGGTATATACCGA
CTGCGGTCAAAAGCGAGGGTGTGATGGTCT|TCACCCTGCGCGCTATCTTAGATTCGATTC
GAAGCCCAGTGGAACCCGCGCATGCGCCGG|CCTCAAGACAATTTCAATCCAGTGGCTTAC
TATAACTGGTGGTAAGCCGTGAGCTGACCC|CTTGGATCGAAGCCCAGTGGAACCCGCGCA
GCAGGTGGGTATGGGCTACCCCAATAGTAG|TTCGAAATTACTACACGACTGCATATGGTT
AGGCAACATCATCACTTAGCTTATACAATA|TTGGGTGGCAGGTGGGTATGGGCTACCCCA
GAACCACCCATGCAATCGGACTCCTAGAAG|CCGCCAGGGACTTCATGCTGTTTTACTCGG
CCCAGCTGGCACCCCTTCTTCTCCCCCTAG|GCATGCGCCGGGAACCACCCATGCAATCGG
CAGGTGGGTATGGGCTACCCCAATAGTAGC|TCGAAATTACTACACGACTGCATATGGTTC
TTTAGTGTAGTTATAGACATCAAGTCTTGG|TGGTCTAGCACAGTATATTGAGCATCTATT
AATCCTGCGATTGTTTTCCGATATTTCAGA|CGAATATTATAGCTTATACAATTACAATCC
ACTGCAGGGAACTCTGCGGTCAAAAGCGAG|TAATCGGGGTATATCACCCTGCGCGCTATC
GCTTATACAATTACAATCCTTCCGAATATA|GTTTAGTGTAGTTATAGACATCAAGTCTTG
TTATAGCTTATACAATTACAATCCTTCCGA|TCAACGTGCCCACCTTAGATGAAAGTCTGC
TCAAGTCTTGGATCGAAGCCCAGTGGAACC|GAGCATCTATTCCCCCTCAAGACAATTTCA
CCCCTAGCTTATACAATTACAATCCTTCCG|CAATCGGACTCCTAGAAGTGACTGATCTGG
AGACATCAAGTCTTGGATCGAAGCCCAGTG|ATATTGAGCATCTATTCCCCCTCAAGACAA
CAATTACAATAGCTTATACAATTACAATCC|CGACCAAAGGCGTCTTTTGGGGGAGGGGAC
CAAGACAATTTCAATCCAGTGGCTTACCCG|CAGAAGGCATGTCTAAAGGTCGGGTTTGGG
CGGTGGGTTTGGTCTAGCACAGTATATTGA|TTACAATCCTTCCGAATAAAATCCTGCGAT
TTAGCTTATACAATAGCTTATACAATTACA|GTATGGGCTACCCCAATAGTAGCGGAACCC
CCACCCATGCAATCGGACTCCTAGAAGTGA|CCAGGGACTTCATGCTGTTTTACTCGGGAA
CGTTTAGTGTAGTTATAGACATCAAGTCTT|TTTGGTCTAGCACAGTATATTGAGCATCTA
ATAGCTTATACAATTACAATCCTTCCGAAT|AACGTGCCCACCTTAGATGAAAGTCTGCCC
CAGTAACTAGCACCGTTTAGTGTAGTTATA|CAACATCGGTGGGTTTGGTCTAGCACAGTA
CCGTCACAATAGCTTATACAATTACAATAG|GCCTCATGGCTTATTCTGCGACCAAAGGCG
ATGCTATTCACACTAGGGATGAGTCGCTTA|GGAGCTGGAAGCTCCGTCCGTCACAATAGC
CTTATACAATAGCTTATACAATTACAATCC|GGGCTACCCCAATAGTAGCGGAACCCAGCC
ATAATATTCTCGCCACCGACGTCGAACCAG|GTCCGGGTGGCAGTCGCCCTACGAATCTTC
TATAGACATCAAGTCTTGGATCGAAGCCCA|AGTATATTGAGCATCTATTCCCCCTCAAGA
ATTACAATCCTTCCGAATACAATCCTTCCG|CTATTCACACTAGGGATGAGTCGCTTAGCT
TGAGTCGCTTAGCTTATACAATTACAATCC|GTCACAATAGCTTATACAATTACAATAGCT
CTTATTCTGCGACCAAAGGCGTCTTTTGGG|CCTTCCGAATAACGCGTGACTGCAGGGAAC
AATCCTTCCGAATATAACTGGTGGTAAGCC|TAGACATCAAGTCTTGGATCGAAGCCCAGT
TTATACAATTACAATCCTTCCGAATAAAAT|TTACAATCCTTCCGAATACAATCCTTCCGA
TTACAATCCTTCCGAATAACGCGTGACTGC|AGCCGTAAATTGGAGGGAAGAGTGCTAATC
AACCCGCGCATGCGCCGGGAACCACCCATG|TTCAATCCAGTGGCTTACCCGCCAGGGACT
ATACAATTACAATCCTTCCGAATATCGTAG|ACAATTACAATAGCTTATACAATTACAATC
TTCTGCGACCAAAGGCGTCTTTTGGGGGAG|CCGAATAACGCGTGACTGCAGGGAACTCTG
GGAGGGAAGAGTGCTAATCGGGGTATATCA|GACTTTAAACACATCCATGGTTCGGAAGAG
GTGGGTATGGGCTACCCCAATAGTAGCGGA|AAATTACTACACGACTGCATATGGTTCTTA
AGGCAAGAATCTCGTAGCTTATACAATTAC|CAATTATAGCTTATACAATTACAATCCTTC
TATACAATTACAATCCTTCCGAATAATATT|TCCGAATATCCTTCCGAATACGGTCCGGGT
GGGAGCTGGAAGCTCCGTCCGTCACAATAG|TATGATACTAGTTGGTTTGCCTCATGGCTT
GGAGCTGGAAGCTCCGTCCGTCACAATAGC|ATGATACTAGTTGGTTTGCCTCATGGCTTA
TATTCTCGCCACCGACGTCGAACCAGGTAC|GGGTGGCAGTCGCCCTACGAATCTTCGAGC
TGATCCAGAGAAGGCAACATCATCACTTAG|ATGGTCTCCACTTGGGTGGCAGGTGGGTAT
TATACAATAGCTTATACAATTACAATCCTT|GCTACCCCAATAGTAGCGGAACCCAGCCCC
TGCAATCGGACTCCTAGAAGTGACTGATCT|CTTCATGCTGTTTTACTCGGGAAGGCAAGA
AACATCATCACTTAGCTTATACAATAGCTT|GTGGCAGGTGGGTATGGGCTACCCCAATAG
CTGGTCGACAGCTACAACATCGGTGGGTTT|GAATCTCGTAGCTTATACAATTACAATCCT
TAAAGGTCGGGTTTGGGGTGCGGTCTAGCT|CAATCCTTCCGAATAGACTTAGCTTATACA
CCTAGCTTATACAATTACAATCCTTCCGAA|ATCGGACTCCTAGAAGTGACTGATCTGGTC
TCGAAGCCCAGTGGAACCCGCGCATGCGCC|CCCCTCAAGACAATTTCAATCCAGTGGCTT
CGAATAAAAAGCCAGTAACTAGCACCGTTT|GGTCGACAGCTACAACATCGGTGGGTTTGG
AAGGCGTCTTTTGGGGGAGGGGACACGGTG|GTGACTGCAGGGAACTCTGCGGTCAAAAGC
ACCGACGTCGAACCAGGTACAGACAATGGG|CGCCCTACGAATCTTCGAGCGCACGCCTAT
AGCTTATACAATTACAATCCTTCCGAATAA|TCCTTCCGAATATCCTTCCGAATACGGTCC
GAACCAGGTACAGACAATGGGAGCTGGAAG|AATCTTCGAGCGCACGCCTATGATACTAGT
AATCGGACTCCTAGAAGTGACTGATCTGGT|CATGCTGTTTTACTCGGGAAGGCAAGAATC
TGCCCACCTTAGATGAAAGTCTGCCCGATT|AATCCTTCCGAATAATATTCTCGCCACCGA
CGTCTTTTGGGGGAGGGGACACGGTGCGTT|CTGCAGGGAACTCTGCGGTCAAAAGCGAGG
GGTATGGGCTACCCCAATAGTAGCGGAACC|TTACTACACGACTGCATATGGTTCTTACAC
TTTCAATCCAGTGGCTTACCCGCCAGGGAC|ATGTCTAAAGGTCGGGTTTGGGGTGCGGTC
CAATTACAATCCTTCCGAATACAATCCTTC|TGCTATTCACACTAGGGATGAGTCGCTTAG
ACAATAGCTTATACAATTACAATAGCTTAT|ATGGCTTATTCTGCGACCAAAGGCGTCTTT
CACAGTATATTGAGCATCTATTCCCCCTCA|AAAATCCTGCGATTGTTTTCCGATATTTCA
CACCCATGCAATCGGACTCCTAGAAGTGAC|CAGGGACTTCATGCTGTTTTACTCGGGAAG
TTATACAATTACAATCCTTCCGAATATCCT|CTTTTGGGGGAGGGGACACGGTGCGTTTTA
TCCTTCCGAATAATATTCTCGCCACCGACG|CCGAATACGGTCCGGGTGGCAGTCGCCCTA
AAAATCCTGCGATTGTTTTCCGATATTTCA|TCCGAATATTATAGCTTATACAATTACAAT
GGGACTTCATGCTGTTTTACTCGGGAAGGC|CGGTCTAGCTTATACAATAGCTTATACAAT
TTGATCCAGAGAAGGCAACATCATCACTTA|GATGGTCTCCACTTGGGTGGCAGGTGGGTA
TACAGACAATGGGAGCTGGAAGCTCCGTCC|AGCGCACGCCTATGATACTAGTTGGTTTGC
CCGTTTAGTGTAGTTATAGACATCAAGTCT|GTTTGGTCTAGCACAGTATATTGAGCATCT
CTTATACAATTACAATCCTTCCGAATAGCT|CCGAATAAAAAGCCAGTAACTAGCACCGTT
CCTACGAATCTTCGAGCGCACGCCTATGAT|CTTAGCTTATACAATAGCTTATACAATTAC
ATCGGACTCCTAGAAGTGACTGATCTGGTC|ATGCTGTTTTACTCGGGAAGGCAAGAATCT
CCGATTTTCGCTATCCCATGGGTCCGTATA|CACCGACGTCGAACCAGGTACAGACAATGG
TACAATCCTTCCGAATAGCTTATACAATTA|AGCCAGTAACTAGCACCGTTTAGTGTAGTT
CCTTCTTCTCCCCCTAGCTTATACAATTAC|ACCACCCATGCAATCGGACTCCTAGAAGTG
TCCTTCCGAATAAAATCCTGCGATTGTTTT|AATACAATCCTTCCGAATATTATAGCTTAT
CTTCCGAATAAAAAGCCAGTAACTAGCACC|ATCTGGTCGACAGCTACAACATCGGTGGGT
ACAATCCTTCCGAATATCCTTCCGAATACG|AGGGGACACGGTGCGTTTTATTTGATCCAG
GTCGACAGCTACAACATCGGTGGGTTTGGT|TCTCGTAGCTTATACAATTACAATCCTTCC
ATACAATTACAATCCTTCCGAATAGCTTAT|AATAAAAAGCCAGTAACTAGCACCGTTTAG
CAAGAATCTCGTAGCTTATACAATTACAAT|TTATAGCTTATACAATTACAATCCTTCCGA
GGGAAGGCAAGAATCTCGTAGCTTATACAA|TATACAATTATAGCTTATACAATTACAATC
CCTTCCGAATACGGTCCGGGTGGCAGTCGC|TTATTTGATCCAGAGAAGGCAACATCATCA
TCTAGCTTATACAATAGCTTATACAATTAT|TTATACAATTACAATCCTTCCGAATATCAA
TAAATTGGAGGGAAGAGTGCTAATCGGGGT|TATACCGACTTTAAACACATCCATGGTTCG
AGCACCGTTTAGTGTAGTTATAGACATCAA|GTGGGTTTGGTCTAGCACAGTATATTGAGC
ACAATCCTTCCGAATATTATAGCTTATACA|GATTTTCGCTATCCCATGGGTCCGTATATG
ACATCATCACTTAGCTTATACAATAGCTTA|TGGCAGGTGGGTATGGGCTACCCCAATAGT
CCGAATAAAATCCTGCGATTGTTTTCCGAT|AATCCTTCCGAATATTATAGCTTATACAAT
CTTCCGAATATTACAATCCTTCCGAATAAC|CCCGGTGGTTAGCCGTAAATTGGAGGGAAG
GGAACCCAGCCCCGGTGGTTAGCCGTAAAT|TTACACCTGACCTTTTGTTTCGGTATATAC
GGGAGGGGACACGGTGCGTTTTATTTGATC|CTCTGCGGTCAAAAGCGAGGGTGTGATGGT
CTACCCCAATAGTAGCGGAACCCAGCCCCG|CGACTGCATATGGTTCTTACACCTGACCTT
TGTGATGGTCTCCACTTGGGTGGCAGGTGG|AGATTCGATTCGTTCCACAAGATTCGAAAT
TGTTTTACTCGGGAAGGCAAGAATCTCGTA|TACAATAGCTTATACAATTATAGCTTATAC
ACCTTAGATGAAAGTCTGCCCGATTTTCGC|TTCCGAATAATATTCTCGCCACCGACGTCG
TTTTCCGATATTTCAGAAGGCATGTCTAAA|TTATACAATTACAATCCTTCCGAATACAAT
GTAGCTTATACAATTACAATCCTTCCGAAT|AATCCTTCCGAATATCCTTCCGAATACGGT
CGAATACAATCCTTCCGAATAGACTTAGCT|GGATGAGTCGCTTAGCTTATACAATTACAA
TTTACTCGGGAAGGCAAGAATCTCGTAGCT|AATAGCTTATACAATTATAGCTTATACAAT
GCCTATGATACTAGTTGGTTTGCCTCATGG|TACAATTACAATCCTTCCGAATATTACAAT
CGAATAATATTCTCGCCACCGACGTCGAAC|ACGGTCCGGGTGGCAGTCGCCCTACGAATC
CGCCAGGGACTTCATGCTGTTTTACTCGGG|GGGTGCGGTCTAGCTTATACAATAGCTTAT
TGAGCATCTATTCCCCCTCAAGACAATTTC|GATTGTTTTCCGATATTTCAGAAGGCATGT
ATCATCACTTAGCTTATACAATAGCTTATA|GCAGGTGGGTATGGGCTACCCCAATAGTAG
GCGATTGTTTTCCGATATTTCAGAAGGCAT|TTATAGCTTATACAATTACAATCCTTCCGA
GCGCACGCCTATGATACTAGTTGGTTTGCC|AGCTTATACAATTACAATCCTTCCGAATAT
CCGAATATCCTTCCGAATACGGTCCGGGTG|GGTGCGTTTTATTTGATCCAGAGAAGGCAA
GTCTCCACTTGGGTGGCAGGTGGGTATGGG|ATTCGTTCCACAAGATTCGAAATTACTACA
AATAGCTTATACAATTATAGCTTATACAAT|AATCCTTCCGAATATCAACGTGCCCACCTT
ATACAATTACAATCCTTCCGAATATAACTG|AGTGTAGTTATAGACATCAAGTCTTGGATC
ACCAGGTACAGACAATGGGAGCTGGAAGCT|TCTTCGAGCGCACGCCTATGATACTAGTTG
GCCCCGGTGGTTAGCCGTAAATTGGAGGGA|GACCTTTTGTTTCGGTATATACCGACTTTA
CCGAATAAAAAGCCAGTAACTAGCACCGTT|TGGTCGACAGCTACAACATCGGTGGGTTTG
CAATCCTTCCGAATACAATCCTTCCGAATA|TCACACTAGGGATGAGTCGCTTAGCTTATA
TAGCTTATACAATTACAATCCTTCCGAATA|ATCCTTCCGAATATCCTTCCGAATACGGTC
TGCGTTTTATTTGATCCAGAGAAGGCAACA|GCGAGGGTGTGATGGTCTCCACTTGGGTGG
CGGTCAAAAGCGAGGGTGTGATGGTCTCCA|CCCTGCGCGCTATCTTAGATTCGATTCGTT
AGCTGGCACCCCTTCTTCTCCCCCTAGCTT|TGCGCCGGGAACCACCCATGCAATCGGACT
TCCTTCCGAATATCGTAGCTTATACAATTA|GCTTATACAATTACAATCCTTCCGAATATC
ACATCGGTGGGTTTGGTCTAGCACAGTATA|ACAATTACAATCCTTCCGAATAAAATCCTG
ATACAATTACAATAGCTTATACAATTACAA|CTGCGACCAAAGGCGTCTTTTGGGGGAGGG
TGCAAAATGGCGTAGCTTATACAATTACAA|ACAATTACAATCCTTCCGAATAAAAAGCCA
AACATCGGTGGGTTTGGTCTAGCACAGTAT|TACAATTACAATCCTTCCGAATAAAATCCT
TCTGCGGTCAAAAGCGAGGGTGTGATGGTC|ATCACCCTGCGCGCTATCTTAGATTCGATT
CAATTTCAATCCAGTGGCTTACCCGCCAGG|GGCATGTCTAAAGGTCGGGTTTGGGGTGCG
CAATAGCTTATACAATTATAGCTTATACAA|CAATCCTTCCGAATATCAACGTGCCCACCT
GGCGTCTTTTGGGGGAGGGGACACGGTGCG|GACTGCAGGGAACTCTGCGGTCAAAAGCGA
GATCGAAGCCCAGTGGAACCCGCGCATGCG|TCCCCCTCAAGACAATTTCAATCCAGTGGC
ATACAATCCTTCCGAATATTATAGCTTATA|CCGATTTTCGCTATCCCATGGGTCCGTATA
ATCCTTCCGAATAGACTTAGCTTATACAAT|CGCTTAGCTTATACAATTACAATCCTTCCG
ATATTGAGCATCTATTCCCCCTCAAGACAA|CTGCGATTGTTTTCCGATATTTCAGAAGGC
GTACAGACAATGGGAGCTGGAAGCTCCGTC|GAGCGCACGCCTATGATACTAGTTGGTTTG
CTAGACATGACCTCCTGCAAAATGGCGTAG|CTCCCCCTAGCTTATACAATTACAATCCTT
TACGGTCCGGGTGGCAGTCGCCCTACGAAT|CCAGAGAAGGCAACATCATCACTTAGCTTA
CCACCGACGTCGAACCAGGTACAGACAATG|GTCGCCCTACGAATCTTCGAGCGCACGCCT
AGTGTAGTTATAGACATCAAGTCTTGGATC|TCTAGCACAGTATATTGAGCATCTATTCCC
CAATAGCTTATACAATTACAATAGCTTATA|TGGCTTATTCTGCGACCAAAGGCGTCTTTT
CCGAATATAACTGGTGGTAAGCCGTGAGCT|CAAGTCTTGGATCGAAGCCCAGTGGAACCC
AATCCTTCCGAATAGCTTATACAATTACAA|CAGTAACTAGCACCGTTTAGTGTAGTTATA
GCACCCCTTCTTCTCCCCCTAGCTTATACA|CGGGAACCACCCATGCAATCGGACTCCTAG
AGTAGCGGAACCCAGCCCCGGTGGTTAGCC|TGGTTCTTACACCTGACCTTTTGTTTCGGT
AGCGCACGCCTATGATACTAGTTGGTTTGC|TAGCTTATACAATTACAATCCTTCCGAATA
ACTCTGCGGTCAAAAGCGAGGGTGTGATGG|ATATCACCCTGCGCGCTATCTTAGATTCGA
GAGCTGGAAGCTCCGTCCGTCACAATAGCT|TGATACTAGTTGGTTTGCCTCATGGCTTAT
ATGCGCCGGGAACCACCCATGCAATCGGAC|GTGGCTTACCCGCCAGGGACTTCATGCTGT
GCAAGAATCTCGTAGCTTATACAATTACAA|ATTATAGCTTATACAATTACAATCCTTCCG
GTAGCTTATACAATTACAATCCTTCCGAAT|TACAATTACAATCCTTCCGAATACAATCCT
CTTCCGAATACGGTCCGGGTGGCAGTCGCC|TATTTGATCCAGAGAAGGCAACATCATCAC
CTCGCCACCGACGTCGAACCAGGTACAGAC|GGCAGTCGCCCTACGAATCTTCGAGCGCAC
CCAGTGGAACCCGCGCATGCGCCGGGAACC|AGACAATTTCAATCCAGTGGCTTACCCGCC
AATATCAACGTGCCCACCTTAGATGAAAGT|ATACAATTACAATCCTTCCGAATAATATTC
ATTGAGCATCTATTCCCCCTCAAGACAATT|GCGATTGTTTTCCGATATTTCAGAAGGCAT
ATGACCTCCTGCAAAATGGCGTAGCTTATA|CTAGCTTATACAATTACAATCCTTCCGAAT
CCGGGAACCACCCATGCAATCGGACTCCTA|TTACCCGCCAGGGACTTCATGCTGTTTTAC
GACCTCCTGCAAAATGGCGTAGCTTATACA|AGCTTATACAATTACAATCCTTCCGAATAA
CCTTCCGAATATCAACGTGCCCACCTTAGA|GTAGCTTATACAATTACAATCCTTCCGAAT
ATACAATTACAATCCTTCCGAATACAATCC|ATATGCTATTCACACTAGGGATGAGTCGCT
AGGGACTTCATGCTGTTTTACTCGGGAAGG|GCGGTCTAGCTTATACAATAGCTTATACAA
GAATAACGCGTGACTGCAGGGAACTCTGCG|AGGGAAGAGTGCTAATCGGGGTATATCACC
TCCTGCAAAATGGCGTAGCTTATACAATTA|TATACAATTACAATCCTTCCGAATAAAAAG
GGACTCCTAGAAGTGACTGATCTGGTCGAC|CTGTTTTACTCGGGAAGGCAAGAATCTCGT
CGTGAGCTGACCCAGCTGGCACCCCTTCTT|TGGAACCCGCGCATGCGCCGGGAACCACCC
TGGAGGGAAGAGTGCTAATCGGGGTATATC|CGACTTTAAACACATCCATGGTTCGGAAGA
CTATTCACACTAGGGATGAGTCGCTTAGCT|GCTGGAAGCTCCGTCCGTCACAATAGCTTA
CTTATACAATTACAATCCTTCCGAATATCG|TATACAATTACAATAGCTTATACAATTACA
CCGTCCGTCACAATAGCTTATACAATTACA|GTTTGCCTCATGGCTTATTCTGCGACCAAA
ACGTCGAACCAGGTACAGACAATGGGAGCT|CTACGAATCTTCGAGCGCACGCCTATGATA
GCGGTCTAGCTTATACAATAGCTTATACAA|TAGCTTATACAATTACAATCCTTCCGAATA
AGCACAGTATATTGAGCATCTATTCCCCCT|ATAAAATCCTGCGATTGTTTTCCGATATTT
ATCCTTCCGAATACAATCCTTCCGAATAGA|ACACTAGGGATGAGTCGCTTAGCTTATACA
CGTCCGTCACAATAGCTTATACAATTACAA|TTTGCCTCATGGCTTATTCTGCGACCAAAG
CCGAATACGGTCCGGGTGGCAGTCGCCCTA|TTGATCCAGAGAAGGCAACATCATCACTTA
CAATCCTTCCGAATATCCTTCCGAATACGG|GGGGACACGGTGCGTTTTATTTGATCCAGA
ATTACAATCCTTCCGAATACAATCCTTCCG|TTAGATGAAAGTCTGCCCGATTTTCGCTAT
CGACAGCTACAACATCGGTGGGTTTGGTCT|TCGTAGCTTATACAATTACAATCCTTCCGA
TCTTCGAGCGCACGCCTATGATACTAGTTG|ATACAATAGCTTATACAATTACAATCCTTC
CATCATCACTTAGCTTATACAATAGCTTAT|GGCAGGTGGGTATGGGCTACCCCAATAGTA
AATCCTTCCGAATATTACAATCCTTCCGAA|CAGCCCCGGTGGTTAGCCGTAAATTGGAGG
CCCAGCCCCGGTGGTTAGCCGTAAATTGGA|ACCTGACCTTTTGTTTCGGTATATACCGAC
